Meldedatum,Neue Fallzahlen,Neue Fallzahlen Mittelwert (7 Tage),Neue Fallzahlen Summe (7 Tage),Faelle gesamt,7 Tage Indizdenz
2020-03-06 00:00:00+00:00,1,0,0,1,0.0
2020-03-08 00:00:00+00:00,1,0,0,2,0.0
2020-03-10 00:00:00+00:00,2,0,0,4,0.0
2020-03-11 00:00:00+00:00,2,0,0,6,0.0
2020-03-12 00:00:00+00:00,10,0,0,16,0.0
2020-03-13 00:00:00+00:00,3,0,0,19,0.0
2020-03-14 00:00:00+00:00,12,4,31,31,5.0
2020-03-15 00:00:00+00:00,10,5,40,41,7.0
2020-03-16 00:00:00+00:00,13,7,52,54,9.0
2020-03-17 00:00:00+00:00,19,9,69,73,11.0
2020-03-18 00:00:00+00:00,17,12,84,90,14.0
2020-03-19 00:00:00+00:00,19,13,93,109,15.0
2020-03-20 00:00:00+00:00,20,15,110,129,18.0
2020-03-21 00:00:00+00:00,11,15,109,140,18.0
2020-03-22 00:00:00+00:00,14,16,113,154,19.0
2020-03-23 00:00:00+00:00,19,17,119,173,20.0
2020-03-24 00:00:00+00:00,16,16,116,189,19.0
2020-03-25 00:00:00+00:00,29,18,128,218,21.0
2020-03-26 00:00:00+00:00,22,18,131,240,22.0
2020-03-27 00:00:00+00:00,19,18,130,259,21.0
2020-03-28 00:00:00+00:00,17,19,136,276,22.0
2020-03-29 00:00:00+00:00,12,19,134,288,22.0
2020-03-30 00:00:00+00:00,21,19,136,309,22.0
2020-03-31 00:00:00+00:00,19,19,139,328,23.0
2020-04-01 00:00:00+00:00,17,18,127,345,21.0
2020-04-02 00:00:00+00:00,17,17,122,362,20.0
2020-04-03 00:00:00+00:00,30,19,133,392,22.0
2020-04-04 00:00:00+00:00,17,19,133,409,22.0
2020-04-05 00:00:00+00:00,10,18,131,419,22.0
2020-04-06 00:00:00+00:00,6,16,116,425,19.0
2020-04-07 00:00:00+00:00,11,15,108,436,18.0
2020-04-08 00:00:00+00:00,6,13,97,442,16.0
2020-04-09 00:00:00+00:00,10,12,90,452,15.0
2020-04-10 00:00:00+00:00,11,10,71,463,12.0
2020-04-11 00:00:00+00:00,7,8,61,470,10.0
2020-04-12 00:00:00+00:00,7,8,58,477,10.0
2020-04-13 00:00:00+00:00,3,7,55,480,9.0
2020-04-14 00:00:00+00:00,4,6,48,484,8.0
2020-04-15 00:00:00+00:00,4,6,46,488,8.0
2020-04-16 00:00:00+00:00,17,7,53,505,9.0
2020-04-17 00:00:00+00:00,4,6,46,509,8.0
2020-04-18 00:00:00+00:00,4,6,43,513,7.0
2020-04-19 00:00:00+00:00,5,5,41,518,7.0
2020-04-20 00:00:00+00:00,2,5,40,520,7.0
2020-04-21 00:00:00+00:00,3,5,39,523,6.0
2020-04-22 00:00:00+00:00,5,5,40,528,7.0
2020-04-23 00:00:00+00:00,3,3,26,531,4.0
2020-04-24 00:00:00+00:00,4,3,26,535,4.0
2020-04-25 00:00:00+00:00,7,4,29,542,5.0
2020-04-27 00:00:00+00:00,6,4,30,548,5.0
2020-04-28 00:00:00+00:00,8,5,36,556,6.0
2020-04-29 00:00:00+00:00,3,5,36,559,6.0
2020-04-30 00:00:00+00:00,2,4,33,561,5.0
2020-05-01 00:00:00+00:00,3,4,33,564,5.0
2020-05-02 00:00:00+00:00,2,4,31,566,5.0
2020-05-05 00:00:00+00:00,2,3,26,568,4.0
2020-05-06 00:00:00+00:00,4,3,24,572,4.0
2020-05-07 00:00:00+00:00,4,2,20,576,3.0
2020-05-08 00:00:00+00:00,4,3,21,580,3.0
2020-05-09 00:00:00+00:00,1,2,20,581,3.0
2020-05-10 00:00:00+00:00,1,2,18,582,3.0
2020-05-11 00:00:00+00:00,2,2,18,584,3.0
2020-05-12 00:00:00+00:00,1,2,17,585,3.0
2020-05-13 00:00:00+00:00,2,2,15,587,2.0
2020-05-14 00:00:00+00:00,3,2,14,590,2.0
2020-05-15 00:00:00+00:00,1,1,11,591,2.0
2020-05-26 00:00:00+00:00,1,1,11,592,2.0
2020-05-29 00:00:00+00:00,1,1,11,593,2.0
2020-06-02 00:00:00+00:00,1,1,10,594,2.0
2020-06-16 00:00:00+00:00,1,1,10,595,2.0
2020-06-17 00:00:00+00:00,2,1,10,597,2.0
2020-06-18 00:00:00+00:00,4,1,11,601,2.0
2020-06-19 00:00:00+00:00,5,2,15,606,2.0
2020-06-22 00:00:00+00:00,4,2,18,610,3.0
2020-06-23 00:00:00+00:00,2,2,19,612,3.0
2020-06-29 00:00:00+00:00,3,3,21,615,3.0
2020-06-30 00:00:00+00:00,3,3,23,618,4.0
2020-07-01 00:00:00+00:00,1,3,22,619,4.0
2020-07-02 00:00:00+00:00,1,2,19,620,3.0
2020-07-03 00:00:00+00:00,1,2,15,621,2.0
2020-07-06 00:00:00+00:00,4,2,15,625,2.0
2020-07-07 00:00:00+00:00,1,2,14,626,2.0
2020-07-09 00:00:00+00:00,3,2,14,629,2.0
2020-07-15 00:00:00+00:00,1,1,12,630,2.0
2020-07-16 00:00:00+00:00,1,1,12,631,2.0
2020-07-17 00:00:00+00:00,1,1,12,632,2.0
2020-07-20 00:00:00+00:00,9,2,20,641,3.0
2020-07-22 00:00:00+00:00,1,2,17,642,3.0
2020-07-23 00:00:00+00:00,4,2,20,646,3.0
2020-07-27 00:00:00+00:00,3,2,20,649,3.0
2020-08-03 00:00:00+00:00,5,3,24,654,4.0
2020-08-05 00:00:00+00:00,4,3,27,658,4.0
2020-08-06 00:00:00+00:00,4,4,30,662,5.0
2020-08-07 00:00:00+00:00,3,3,24,665,4.0
2020-08-10 00:00:00+00:00,3,3,26,668,4.0
2020-08-11 00:00:00+00:00,2,3,24,670,4.0
2020-08-12 00:00:00+00:00,3,3,24,673,4.0
2020-08-13 00:00:00+00:00,4,3,23,677,4.0
2020-08-14 00:00:00+00:00,2,3,21,679,3.0
2020-08-17 00:00:00+00:00,7,3,24,686,4.0
2020-08-18 00:00:00+00:00,6,3,27,692,4.0
2020-08-19 00:00:00+00:00,5,4,29,697,5.0
2020-08-20 00:00:00+00:00,4,4,31,701,5.0
2020-08-21 00:00:00+00:00,5,4,33,706,5.0
2020-08-22 00:00:00+00:00,3,4,32,709,5.0
2020-08-24 00:00:00+00:00,5,5,35,714,6.0
2020-08-25 00:00:00+00:00,7,5,35,721,6.0
2020-08-26 00:00:00+00:00,7,5,36,728,6.0
2020-08-27 00:00:00+00:00,3,4,34,731,6.0
2020-08-28 00:00:00+00:00,2,4,32,733,5.0
2020-08-31 00:00:00+00:00,9,5,36,742,6.0
2020-09-01 00:00:00+00:00,12,6,45,754,7.0
2020-09-02 00:00:00+00:00,10,7,50,764,8.0
2020-09-03 00:00:00+00:00,7,7,50,771,8.0
2020-09-04 00:00:00+00:00,7,7,50,778,8.0
2020-09-07 00:00:00+00:00,10,8,57,788,9.0
2020-09-08 00:00:00+00:00,5,8,60,793,10.0
2020-09-09 00:00:00+00:00,5,8,56,798,9.0
2020-09-10 00:00:00+00:00,9,7,53,807,9.0
2020-09-11 00:00:00+00:00,5,6,48,812,8.0
2020-09-14 00:00:00+00:00,8,7,49,820,8.0
2020-09-15 00:00:00+00:00,3,6,45,823,7.0
2020-09-16 00:00:00+00:00,6,5,41,829,7.0
2020-09-17 00:00:00+00:00,4,5,40,833,7.0
2020-09-18 00:00:00+00:00,10,6,45,843,7.0
2020-09-19 00:00:00+00:00,5,5,41,848,7.0
2020-09-20 00:00:00+00:00,1,5,37,849,6.0
2020-09-21 00:00:00+00:00,6,5,35,855,6.0
2020-09-22 00:00:00+00:00,6,5,38,861,6.0
2020-09-23 00:00:00+00:00,10,6,42,871,7.0
2020-09-24 00:00:00+00:00,9,6,47,880,8.0
2020-09-25 00:00:00+00:00,7,6,44,887,7.0
2020-09-26 00:00:00+00:00,3,6,42,890,7.0
2020-09-28 00:00:00+00:00,3,6,44,893,7.0
2020-09-29 00:00:00+00:00,3,5,41,896,7.0
2020-09-30 00:00:00+00:00,9,6,44,905,7.0
2020-10-01 00:00:00+00:00,6,5,40,911,7.0
2020-10-02 00:00:00+00:00,22,7,53,933,9.0
2020-10-03 00:00:00+00:00,8,7,54,941,9.0
2020-10-04 00:00:00+00:00,1,7,52,942,9.0
2020-10-05 00:00:00+00:00,6,7,55,948,9.0
2020-10-06 00:00:00+00:00,8,8,60,956,10.0
2020-10-07 00:00:00+00:00,8,8,59,964,10.0
2020-10-08 00:00:00+00:00,19,10,72,983,12.0
2020-10-09 00:00:00+00:00,11,8,61,994,10.0
2020-10-10 00:00:00+00:00,13,9,66,1007,11.0
2020-10-11 00:00:00+00:00,3,9,68,1010,11.0
2020-10-12 00:00:00+00:00,11,10,73,1021,12.0
2020-10-13 00:00:00+00:00,11,10,76,1032,13.0
2020-10-14 00:00:00+00:00,12,11,80,1044,13.0
2020-10-15 00:00:00+00:00,22,11,83,1066,14.0
2020-10-16 00:00:00+00:00,27,14,99,1093,16.0
2020-10-19 00:00:00+00:00,35,17,121,1128,20.0
2020-10-20 00:00:00+00:00,26,20,144,1154,24.0
2020-10-21 00:00:00+00:00,28,23,161,1182,27.0
2020-10-22 00:00:00+00:00,33,26,183,1215,30.0
2020-10-23 00:00:00+00:00,32,29,203,1247,34.0
2020-10-24 00:00:00+00:00,2,26,183,1249,30.0
2020-10-25 00:00:00+00:00,2,22,158,1251,26.0
2020-10-26 00:00:00+00:00,48,24,171,1299,28.0
2020-10-27 00:00:00+00:00,37,26,182,1336,30.0
2020-10-28 00:00:00+00:00,69,31,223,1405,37.0
2020-10-29 00:00:00+00:00,62,36,252,1467,42.0
2020-10-30 00:00:00+00:00,41,37,261,1508,43.0
2020-10-31 00:00:00+00:00,56,45,315,1564,52.0
2020-11-01 00:00:00+00:00,40,50,353,1604,58.0
2020-11-02 00:00:00+00:00,26,47,331,1630,55.0
2020-11-03 00:00:00+00:00,72,52,366,1702,60.0
2020-11-04 00:00:00+00:00,54,50,351,1756,58.0
2020-11-05 00:00:00+00:00,93,54,382,1849,63.0
2020-11-06 00:00:00+00:00,81,60,422,1930,70.0
2020-11-07 00:00:00+00:00,21,55,387,1951,64.0
2020-11-08 00:00:00+00:00,83,61,430,2034,71.0
2020-11-09 00:00:00+00:00,77,68,481,2111,79.0
2020-11-10 00:00:00+00:00,83,70,492,2194,81.0
2020-11-11 00:00:00+00:00,105,77,543,2299,90.0
2020-11-12 00:00:00+00:00,59,72,509,2358,84.0
2020-11-13 00:00:00+00:00,74,71,502,2432,83.0
2020-11-14 00:00:00+00:00,101,83,582,2533,96.0
2020-11-15 00:00:00+00:00,77,82,576,2610,95.0
2020-11-16 00:00:00+00:00,15,73,514,2625,85.0
2020-11-17 00:00:00+00:00,89,74,520,2714,86.0
2020-11-18 00:00:00+00:00,84,71,499,2798,82.0
2020-11-19 00:00:00+00:00,109,78,549,2907,91.0
2020-11-20 00:00:00+00:00,56,75,531,2963,88.0
2020-11-21 00:00:00+00:00,81,73,511,3044,84.0
2020-11-22 00:00:00+00:00,132,80,566,3176,93.0
2020-11-23 00:00:00+00:00,38,84,589,3214,97.0
2020-11-24 00:00:00+00:00,89,84,589,3303,97.0
2020-11-25 00:00:00+00:00,145,92,650,3448,107.0
2020-11-26 00:00:00+00:00,124,95,665,3572,110.0
2020-11-27 00:00:00+00:00,126,105,735,3698,121.0
2020-11-28 00:00:00+00:00,90,106,744,3788,123.0
2020-11-29 00:00:00+00:00,92,100,704,3880,116.0
2020-11-30 00:00:00+00:00,83,107,749,3963,124.0
2020-12-01 00:00:00+00:00,81,105,741,4044,122.0
2020-12-02 00:00:00+00:00,207,114,803,4251,133.0
2020-12-03 00:00:00+00:00,154,119,833,4405,138.0
2020-12-04 00:00:00+00:00,55,108,762,4460,126.0
2020-12-05 00:00:00+00:00,140,116,812,4600,134.0
2020-12-06 00:00:00+00:00,185,129,905,4785,149.0
2020-12-07 00:00:00+00:00,76,128,898,4861,148.0
2020-12-08 00:00:00+00:00,38,122,855,4899,141.0
2020-12-09 00:00:00+00:00,118,109,766,5017,127.0
2020-12-10 00:00:00+00:00,268,125,880,5285,145.0
2020-12-11 00:00:00+00:00,92,131,917,5377,151.0
2020-12-12 00:00:00+00:00,84,123,861,5461,142.0
2020-12-13 00:00:00+00:00,58,104,734,5519,121.0
2020-12-14 00:00:00+00:00,269,132,927,5788,153.0
2020-12-15 00:00:00+00:00,227,159,1116,6015,184.0
2020-12-16 00:00:00+00:00,246,177,1244,6261,205.0
2020-12-17 00:00:00+00:00,251,175,1227,6512,203.0
2020-12-18 00:00:00+00:00,217,193,1352,6729,223.0
2020-12-19 00:00:00+00:00,121,198,1389,6850,229.0
2020-12-20 00:00:00+00:00,349,240,1680,7199,277.0
2020-12-21 00:00:00+00:00,231,234,1642,7430,271.0
2020-12-22 00:00:00+00:00,224,234,1639,7654,271.0
2020-12-23 00:00:00+00:00,185,225,1578,7839,261.0
2020-12-24 00:00:00+00:00,245,224,1572,8084,260.0
2020-12-25 00:00:00+00:00,163,216,1518,8247,251.0
2020-12-26 00:00:00+00:00,247,234,1644,8494,272.0
2020-12-27 00:00:00+00:00,207,214,1502,8701,248.0
2020-12-28 00:00:00+00:00,76,192,1347,8777,222.0
2020-12-29 00:00:00+00:00,171,184,1294,8948,214.0
2020-12-30 00:00:00+00:00,171,182,1280,9119,211.0
2020-12-31 00:00:00+00:00,287,188,1322,9406,218.0
2021-01-01 00:00:00+00:00,123,183,1282,9529,212.0
2021-01-02 00:00:00+00:00,156,170,1191,9685,197.0
2021-01-03 00:00:00+00:00,136,160,1120,9821,185.0
2021-01-04 00:00:00+00:00,109,164,1153,9930,190.0
2021-01-05 00:00:00+00:00,373,193,1355,10303,224.0
2021-01-06 00:00:00+00:00,220,200,1404,10523,232.0
2021-01-07 00:00:00+00:00,111,175,1228,10634,203.0
2021-01-08 00:00:00+00:00,245,192,1350,10879,223.0
2021-01-09 00:00:00+00:00,88,183,1282,10967,212.0
2021-01-10 00:00:00+00:00,178,189,1324,11145,219.0
2021-01-11 00:00:00+00:00,274,212,1489,11419,246.0
2021-01-12 00:00:00+00:00,209,189,1325,11628,219.0
2021-01-13 00:00:00+00:00,181,183,1286,11809,212.0
2021-01-14 00:00:00+00:00,243,202,1418,12052,234.0
2021-01-15 00:00:00+00:00,166,191,1339,12218,221.0
2021-01-16 00:00:00+00:00,129,197,1380,12347,228.0
2021-01-17 00:00:00+00:00,46,178,1248,12393,206.0
2021-01-18 00:00:00+00:00,71,149,1045,12464,173.0
2021-01-19 00:00:00+00:00,239,153,1075,12703,178.0
2021-01-20 00:00:00+00:00,169,151,1063,12872,176.0
2021-01-21 00:00:00+00:00,185,143,1005,13057,166.0
2021-01-22 00:00:00+00:00,118,136,957,13175,158.0
2021-01-23 00:00:00+00:00,113,134,941,13288,155.0
2021-01-24 00:00:00+00:00,43,134,938,13331,155.0
2021-01-25 00:00:00+00:00,22,127,889,13353,147.0
2021-01-26 00:00:00+00:00,145,113,795,13498,131.0
2021-01-27 00:00:00+00:00,155,111,781,13653,129.0
2021-01-28 00:00:00+00:00,79,96,675,13732,111.0
2021-01-29 00:00:00+00:00,73,90,630,13805,104.0
2021-01-30 00:00:00+00:00,58,82,575,13863,95.0
2021-01-31 00:00:00+00:00,28,80,560,13891,92.0
2021-02-01 00:00:00+00:00,38,82,576,13929,95.0
2021-02-02 00:00:00+00:00,91,74,522,14020,86.0
2021-02-03 00:00:00+00:00,78,63,445,14098,74.0
2021-02-04 00:00:00+00:00,91,65,457,14189,75.0
2021-02-05 00:00:00+00:00,69,64,453,14258,75.0
2021-02-06 00:00:00+00:00,35,61,430,14293,71.0
2021-02-07 00:00:00+00:00,6,58,408,14299,67.0
2021-02-08 00:00:00+00:00,17,55,387,14316,64.0
2021-02-09 00:00:00+00:00,69,52,365,14385,60.0
2021-02-10 00:00:00+00:00,59,49,346,14444,57.0
2021-02-11 00:00:00+00:00,36,41,291,14480,48.0
2021-02-12 00:00:00+00:00,61,40,283,14541,47.0
2021-02-13 00:00:00+00:00,32,40,280,14573,46.0
2021-02-14 00:00:00+00:00,2,39,276,14575,46.0
2021-02-15 00:00:00+00:00,12,38,271,14587,45.0
2021-02-16 00:00:00+00:00,64,38,266,14651,44.0
2021-02-17 00:00:00+00:00,39,35,246,14690,41.0
2021-02-18 00:00:00+00:00,46,36,256,14736,42.0
2021-02-19 00:00:00+00:00,49,34,244,14785,40.0
2021-02-20 00:00:00+00:00,46,36,258,14831,43.0
2021-02-21 00:00:00+00:00,12,38,268,14843,44.0
2021-02-22 00:00:00+00:00,23,39,279,14866,46.0
2021-02-23 00:00:00+00:00,98,44,313,14964,52.0
2021-02-24 00:00:00+00:00,58,47,332,15022,55.0
2021-02-25 00:00:00+00:00,62,49,348,15084,57.0
2021-02-26 00:00:00+00:00,41,48,340,15125,56.0
2021-02-27 00:00:00+00:00,38,47,332,15163,55.0
2021-02-28 00:00:00+00:00,12,47,332,15175,55.0
2021-03-01 00:00:00+00:00,20,47,329,15195,54.0
2021-03-02 00:00:00+00:00,82,44,313,15277,52.0
2021-03-03 00:00:00+00:00,67,46,322,15344,53.0
2021-03-04 00:00:00+00:00,42,43,302,15386,50.0
2021-03-05 00:00:00+00:00,44,43,305,15430,50.0
2021-03-06 00:00:00+00:00,30,42,297,15460,49.0
2021-03-07 00:00:00+00:00,11,42,296,15471,49.0
2021-03-08 00:00:00+00:00,36,44,312,15507,52.0
2021-03-09 00:00:00+00:00,89,45,319,15596,53.0
2021-03-10 00:00:00+00:00,63,45,315,15659,52.0
2021-03-11 00:00:00+00:00,52,46,325,15711,54.0
2021-03-12 00:00:00+00:00,68,49,349,15779,58.0
2021-03-13 00:00:00+00:00,75,56,394,15854,65.0
2021-03-14 00:00:00+00:00,6,55,389,15860,64.0
2021-03-15 00:00:00+00:00,26,54,379,15886,63.0
2021-03-16 00:00:00+00:00,98,55,388,15984,64.0
2021-03-17 00:00:00+00:00,96,60,421,16080,70.0
2021-03-18 00:00:00+00:00,133,71,502,16213,83.0
2021-03-19 00:00:00+00:00,92,75,526,16305,87.0
2021-03-20 00:00:00+00:00,45,70,496,16350,82.0
2021-03-21 00:00:00+00:00,59,78,549,16409,91.0
2021-03-22 00:00:00+00:00,25,78,548,16434,91.0
2021-03-23 00:00:00+00:00,132,83,582,16566,96.0
2021-03-24 00:00:00+00:00,137,89,623,16703,103.0
2021-03-25 00:00:00+00:00,108,85,598,16811,99.0
2021-03-26 00:00:00+00:00,96,86,602,16907,99.0
2021-03-27 00:00:00+00:00,27,83,584,16934,96.0
2021-03-28 00:00:00+00:00,96,88,621,17030,103.0
2021-03-29 00:00:00+00:00,58,93,654,17088,108.0
2021-03-30 00:00:00+00:00,147,95,669,17235,111.0
2021-03-31 00:00:00+00:00,154,98,686,17389,113.0
2021-04-01 00:00:00+00:00,112,98,690,17501,114.0
2021-04-02 00:00:00+00:00,23,88,617,17524,102.0
2021-04-03 00:00:00+00:00,162,107,752,17686,124.0
2021-04-04 00:00:00+00:00,38,99,694,17724,115.0
2021-04-05 00:00:00+00:00,21,93,657,17745,109.0
2021-04-06 00:00:00+00:00,92,86,602,17837,99.0
2021-04-07 00:00:00+00:00,196,92,644,18033,106.0
2021-04-08 00:00:00+00:00,144,96,676,18177,112.0
2021-04-09 00:00:00+00:00,137,112,790,18314,130.0
2021-04-10 00:00:00+00:00,78,100,706,18392,117.0
2021-04-11 00:00:00+00:00,85,107,753,18477,124.0
2021-04-12 00:00:00+00:00,102,119,834,18579,138.0
2021-04-13 00:00:00+00:00,236,139,978,18815,162.0
2021-04-14 00:00:00+00:00,168,135,950,18983,157.0
2021-04-15 00:00:00+00:00,137,134,943,19120,156.0
2021-04-16 00:00:00+00:00,120,132,926,19240,153.0
2021-04-17 00:00:00+00:00,63,130,911,19303,150.0
2021-04-18 00:00:00+00:00,48,124,874,19351,144.0
2021-04-19 00:00:00+00:00,49,117,821,19400,136.0
2021-04-20 00:00:00+00:00,187,110,772,19587,128.0
2021-04-21 00:00:00+00:00,143,106,747,19730,123.0
2021-04-22 00:00:00+00:00,140,107,750,19870,124.0
2021-04-23 00:00:00+00:00,90,102,720,19960,119.0
2021-04-24 00:00:00+00:00,90,106,747,20050,123.0
2021-04-25 00:00:00+00:00,55,107,754,20105,125.0
2021-04-26 00:00:00+00:00,55,108,760,20160,126.0
2021-04-27 00:00:00+00:00,185,108,758,20345,125.0
2021-04-28 00:00:00+00:00,123,105,738,20468,122.0
2021-04-29 00:00:00+00:00,119,102,717,20587,118.0
2021-04-30 00:00:00+00:00,110,105,737,20697,122.0
2021-05-01 00:00:00+00:00,33,97,680,20730,112.0
2021-05-02 00:00:00+00:00,62,98,687,20792,113.0
2021-05-03 00:00:00+00:00,57,98,689,20849,114.0
2021-05-04 00:00:00+00:00,161,95,665,21010,110.0
2021-05-05 00:00:00+00:00,92,90,634,21102,105.0
2021-05-06 00:00:00+00:00,79,84,594,21181,98.0
2021-05-07 00:00:00+00:00,82,80,566,21263,93.0
2021-05-08 00:00:00+00:00,45,82,578,21308,95.0
2021-05-09 00:00:00+00:00,36,78,552,21344,91.0
2021-05-10 00:00:00+00:00,38,76,533,21382,88.0
2021-05-11 00:00:00+00:00,111,69,483,21493,80.0
2021-05-12 00:00:00+00:00,81,67,472,21574,78.0
2021-05-13 00:00:00+00:00,29,60,422,21603,70.0
2021-05-14 00:00:00+00:00,45,55,385,21648,64.0
2021-05-15 00:00:00+00:00,33,53,373,21681,62.0
2021-05-16 00:00:00+00:00,23,51,360,21704,59.0
2021-05-17 00:00:00+00:00,57,54,379,21761,63.0
2021-05-18 00:00:00+00:00,70,48,338,21831,56.0
2021-05-19 00:00:00+00:00,71,46,328,21902,54.0
2021-05-20 00:00:00+00:00,55,50,354,21957,58.0
2021-05-21 00:00:00+00:00,32,48,341,21989,56.0
2021-05-22 00:00:00+00:00,31,48,339,22020,56.0
2021-05-23 00:00:00+00:00,6,46,322,22026,53.0
2021-05-24 00:00:00+00:00,4,38,269,22030,44.0
2021-05-25 00:00:00+00:00,24,31,223,22054,37.0
2021-05-26 00:00:00+00:00,46,28,198,22100,33.0
2021-05-27 00:00:00+00:00,34,25,177,22134,29.0
2021-05-28 00:00:00+00:00,32,25,177,22166,29.0
2021-05-29 00:00:00+00:00,9,22,155,22175,26.0
2021-05-30 00:00:00+00:00,9,22,158,22184,26.0
2021-05-31 00:00:00+00:00,16,24,170,22200,28.0
2021-06-01 00:00:00+00:00,19,23,165,22219,27.0
2021-06-02 00:00:00+00:00,24,20,143,22243,24.0
2021-06-03 00:00:00+00:00,15,17,124,22258,20.0
2021-06-04 00:00:00+00:00,10,14,102,22268,17.0
2021-06-05 00:00:00+00:00,8,14,101,22276,17.0
2021-06-06 00:00:00+00:00,5,13,97,22281,16.0
2021-06-07 00:00:00+00:00,10,13,91,22291,15.0
2021-06-08 00:00:00+00:00,18,12,90,22309,15.0
2021-06-09 00:00:00+00:00,8,10,74,22317,12.0
2021-06-10 00:00:00+00:00,8,9,67,22325,11.0
2021-06-11 00:00:00+00:00,2,8,59,22327,10.0
2021-06-14 00:00:00+00:00,13,9,64,22340,11.0
2021-06-15 00:00:00+00:00,20,11,79,22360,13.0
2021-06-16 00:00:00+00:00,1,10,70,22361,12.0
2021-06-17 00:00:00+00:00,8,8,60,22369,10.0
2021-06-18 00:00:00+00:00,4,8,56,22373,9.0
2021-06-20 00:00:00+00:00,1,7,49,22374,8.0
2021-06-21 00:00:00+00:00,5,7,52,22379,9.0
2021-06-22 00:00:00+00:00,11,7,50,22390,8.0
2021-06-23 00:00:00+00:00,1,4,31,22391,5.0
2021-06-24 00:00:00+00:00,8,5,38,22399,6.0
2021-06-25 00:00:00+00:00,2,4,32,22401,5.0
2021-06-26 00:00:00+00:00,2,4,30,22403,5.0
2021-06-27 00:00:00+00:00,1,4,30,22404,5.0
2021-06-28 00:00:00+00:00,3,4,28,22407,5.0
2021-06-29 00:00:00+00:00,3,2,20,22410,3.0
2021-06-30 00:00:00+00:00,2,3,21,22412,3.0
2021-07-01 00:00:00+00:00,4,2,17,22416,3.0
2021-07-02 00:00:00+00:00,2,2,17,22418,3.0
2021-07-03 00:00:00+00:00,1,2,16,22419,3.0
2021-07-05 00:00:00+00:00,2,2,17,22421,3.0
2021-07-06 00:00:00+00:00,3,2,17,22424,3.0
