Meldedatum,Bundesland,Neue Fallzahlen,Neue Fallzahlen Mittelwert (7 Tage),Neue Fallzahlen Summe (7 Tage),Faelle gesamt,7 Tage Indizdenz
2020-01-02 00:00:00+00:00,Nordrhein-Westfalen,1,0,0,1,0.0
2020-02-20 00:00:00+00:00,Nordrhein-Westfalen,1,0,0,2,0.0
2020-02-26 00:00:00+00:00,Nordrhein-Westfalen,3,0,0,5,0.0
2020-02-27 00:00:00+00:00,Nordrhein-Westfalen,18,0,0,23,0.0
2020-02-28 00:00:00+00:00,Nordrhein-Westfalen,34,0,0,57,0.0
2020-02-29 00:00:00+00:00,Nordrhein-Westfalen,15,0,0,72,0.0
2020-03-01 00:00:00+00:00,Nordrhein-Westfalen,23,13,95,95,1.0
2020-03-02 00:00:00+00:00,Nordrhein-Westfalen,15,15,109,110,1.0
2020-03-03 00:00:00+00:00,Nordrhein-Westfalen,29,19,137,139,1.0
2020-03-04 00:00:00+00:00,Nordrhein-Westfalen,93,32,227,232,1.0
2020-03-05 00:00:00+00:00,Nordrhein-Westfalen,99,44,308,331,2.0
2020-03-06 00:00:00+00:00,Nordrhein-Westfalen,62,48,336,393,2.0
2020-03-07 00:00:00+00:00,Nordrhein-Westfalen,68,55,389,461,2.0
2020-03-08 00:00:00+00:00,Nordrhein-Westfalen,28,56,394,489,2.0
2020-03-09 00:00:00+00:00,Nordrhein-Westfalen,97,68,476,586,3.0
2020-03-10 00:00:00+00:00,Nordrhein-Westfalen,174,88,621,760,3.0
2020-03-11 00:00:00+00:00,Nordrhein-Westfalen,200,104,728,960,4.0
2020-03-12 00:00:00+00:00,Nordrhein-Westfalen,287,130,916,1247,5.0
2020-03-13 00:00:00+00:00,Nordrhein-Westfalen,426,182,1280,1673,7.0
2020-03-14 00:00:00+00:00,Nordrhein-Westfalen,323,219,1535,1996,9.0
2020-03-15 00:00:00+00:00,Nordrhein-Westfalen,242,249,1749,2238,10.0
2020-03-16 00:00:00+00:00,Nordrhein-Westfalen,609,323,2261,2847,13.0
2020-03-17 00:00:00+00:00,Nordrhein-Westfalen,902,427,2989,3749,17.0
2020-03-18 00:00:00+00:00,Nordrhein-Westfalen,714,500,3503,4463,20.0
2020-03-19 00:00:00+00:00,Nordrhein-Westfalen,1143,622,4359,5606,24.0
2020-03-20 00:00:00+00:00,Nordrhein-Westfalen,880,687,4813,6486,27.0
2020-03-21 00:00:00+00:00,Nordrhein-Westfalen,695,740,5185,7181,29.0
2020-03-22 00:00:00+00:00,Nordrhein-Westfalen,435,768,5378,7616,30.0
2020-03-23 00:00:00+00:00,Nordrhein-Westfalen,877,806,5646,8493,31.0
2020-03-24 00:00:00+00:00,Nordrhein-Westfalen,799,791,5543,9292,31.0
2020-03-25 00:00:00+00:00,Nordrhein-Westfalen,1038,838,5867,10330,33.0
2020-03-26 00:00:00+00:00,Nordrhein-Westfalen,1041,823,5765,11371,32.0
2020-03-27 00:00:00+00:00,Nordrhein-Westfalen,1095,854,5980,12466,33.0
2020-03-28 00:00:00+00:00,Nordrhein-Westfalen,748,861,6033,13214,34.0
2020-03-29 00:00:00+00:00,Nordrhein-Westfalen,629,889,6227,13843,35.0
2020-03-30 00:00:00+00:00,Nordrhein-Westfalen,762,873,6112,14605,34.0
2020-03-31 00:00:00+00:00,Nordrhein-Westfalen,1059,910,6372,15664,36.0
2020-04-01 00:00:00+00:00,Nordrhein-Westfalen,1155,927,6489,16819,36.0
2020-04-02 00:00:00+00:00,Nordrhein-Westfalen,1204,950,6652,18023,37.0
2020-04-03 00:00:00+00:00,Nordrhein-Westfalen,1055,944,6612,19078,37.0
2020-04-04 00:00:00+00:00,Nordrhein-Westfalen,686,935,6550,19764,36.0
2020-04-05 00:00:00+00:00,Nordrhein-Westfalen,508,918,6429,20272,36.0
2020-04-06 00:00:00+00:00,Nordrhein-Westfalen,871,934,6538,21143,36.0
2020-04-07 00:00:00+00:00,Nordrhein-Westfalen,915,913,6394,22058,36.0
2020-04-08 00:00:00+00:00,Nordrhein-Westfalen,1043,897,6282,23101,35.0
2020-04-09 00:00:00+00:00,Nordrhein-Westfalen,1011,869,6089,24112,34.0
2020-04-10 00:00:00+00:00,Nordrhein-Westfalen,623,808,5657,24735,32.0
2020-04-11 00:00:00+00:00,Nordrhein-Westfalen,581,793,5552,25316,31.0
2020-04-12 00:00:00+00:00,Nordrhein-Westfalen,382,775,5426,25698,30.0
2020-04-13 00:00:00+00:00,Nordrhein-Westfalen,296,693,4851,25994,27.0
2020-04-14 00:00:00+00:00,Nordrhein-Westfalen,511,635,4447,26505,25.0
2020-04-15 00:00:00+00:00,Nordrhein-Westfalen,665,581,4069,27170,23.0
2020-04-16 00:00:00+00:00,Nordrhein-Westfalen,737,542,3795,27907,21.0
2020-04-17 00:00:00+00:00,Nordrhein-Westfalen,635,543,3807,28542,21.0
2020-04-18 00:00:00+00:00,Nordrhein-Westfalen,467,527,3693,29009,21.0
2020-04-19 00:00:00+00:00,Nordrhein-Westfalen,338,521,3649,29347,20.0
2020-04-20 00:00:00+00:00,Nordrhein-Westfalen,550,557,3903,29897,22.0
2020-04-21 00:00:00+00:00,Nordrhein-Westfalen,456,549,3848,30353,21.0
2020-04-22 00:00:00+00:00,Nordrhein-Westfalen,475,522,3658,30828,20.0
2020-04-23 00:00:00+00:00,Nordrhein-Westfalen,391,473,3312,31219,18.0
2020-04-24 00:00:00+00:00,Nordrhein-Westfalen,334,430,3011,31553,17.0
2020-04-25 00:00:00+00:00,Nordrhein-Westfalen,220,394,2764,31773,15.0
2020-04-26 00:00:00+00:00,Nordrhein-Westfalen,152,368,2578,31925,14.0
2020-04-27 00:00:00+00:00,Nordrhein-Westfalen,224,321,2252,32149,13.0
2020-04-28 00:00:00+00:00,Nordrhein-Westfalen,266,294,2062,32415,11.0
2020-04-29 00:00:00+00:00,Nordrhein-Westfalen,248,262,1835,32663,10.0
2020-04-30 00:00:00+00:00,Nordrhein-Westfalen,384,261,1828,33047,10.0
2020-05-01 00:00:00+00:00,Nordrhein-Westfalen,232,246,1726,33279,10.0
2020-05-02 00:00:00+00:00,Nordrhein-Westfalen,146,236,1652,33425,9.0
2020-05-03 00:00:00+00:00,Nordrhein-Westfalen,119,231,1619,33544,9.0
2020-05-04 00:00:00+00:00,Nordrhein-Westfalen,173,224,1568,33717,9.0
2020-05-05 00:00:00+00:00,Nordrhein-Westfalen,240,220,1542,33957,9.0
2020-05-06 00:00:00+00:00,Nordrhein-Westfalen,319,230,1613,34276,9.0
2020-05-07 00:00:00+00:00,Nordrhein-Westfalen,320,221,1549,34596,9.0
2020-05-08 00:00:00+00:00,Nordrhein-Westfalen,214,218,1531,34810,9.0
2020-05-09 00:00:00+00:00,Nordrhein-Westfalen,190,225,1575,35000,9.0
2020-05-10 00:00:00+00:00,Nordrhein-Westfalen,104,222,1560,35104,9.0
2020-05-11 00:00:00+00:00,Nordrhein-Westfalen,206,227,1593,35310,9.0
2020-05-12 00:00:00+00:00,Nordrhein-Westfalen,235,226,1588,35545,9.0
2020-05-13 00:00:00+00:00,Nordrhein-Westfalen,213,211,1482,35758,8.0
2020-05-14 00:00:00+00:00,Nordrhein-Westfalen,198,194,1360,35956,8.0
2020-05-15 00:00:00+00:00,Nordrhein-Westfalen,232,196,1378,36188,8.0
2020-05-16 00:00:00+00:00,Nordrhein-Westfalen,138,189,1326,36326,7.0
2020-05-17 00:00:00+00:00,Nordrhein-Westfalen,90,187,1312,36416,7.0
2020-05-18 00:00:00+00:00,Nordrhein-Westfalen,181,183,1287,36597,7.0
2020-05-19 00:00:00+00:00,Nordrhein-Westfalen,194,178,1246,36791,7.0
2020-05-20 00:00:00+00:00,Nordrhein-Westfalen,158,170,1191,36949,7.0
2020-05-21 00:00:00+00:00,Nordrhein-Westfalen,106,157,1099,37055,6.0
2020-05-22 00:00:00+00:00,Nordrhein-Westfalen,96,137,963,37151,5.0
2020-05-23 00:00:00+00:00,Nordrhein-Westfalen,73,128,898,37224,5.0
2020-05-24 00:00:00+00:00,Nordrhein-Westfalen,56,123,864,37280,5.0
2020-05-25 00:00:00+00:00,Nordrhein-Westfalen,134,116,817,37414,5.0
2020-05-26 00:00:00+00:00,Nordrhein-Westfalen,146,109,769,37560,4.0
2020-05-27 00:00:00+00:00,Nordrhein-Westfalen,139,107,750,37699,4.0
2020-05-28 00:00:00+00:00,Nordrhein-Westfalen,118,108,762,37817,4.0
2020-05-29 00:00:00+00:00,Nordrhein-Westfalen,97,109,763,37914,4.0
2020-05-30 00:00:00+00:00,Nordrhein-Westfalen,84,110,774,37998,4.0
2020-05-31 00:00:00+00:00,Nordrhein-Westfalen,44,108,762,38042,4.0
2020-06-01 00:00:00+00:00,Nordrhein-Westfalen,43,95,671,38085,4.0
2020-06-02 00:00:00+00:00,Nordrhein-Westfalen,91,88,616,38176,3.0
2020-06-03 00:00:00+00:00,Nordrhein-Westfalen,118,85,595,38294,3.0
2020-06-04 00:00:00+00:00,Nordrhein-Westfalen,135,87,612,38429,3.0
2020-06-05 00:00:00+00:00,Nordrhein-Westfalen,114,89,629,38543,4.0
2020-06-06 00:00:00+00:00,Nordrhein-Westfalen,95,91,640,38638,4.0
2020-06-07 00:00:00+00:00,Nordrhein-Westfalen,41,91,637,38679,4.0
2020-06-08 00:00:00+00:00,Nordrhein-Westfalen,82,96,676,38761,4.0
2020-06-09 00:00:00+00:00,Nordrhein-Westfalen,123,101,708,38884,4.0
2020-06-10 00:00:00+00:00,Nordrhein-Westfalen,145,105,735,39029,4.0
2020-06-11 00:00:00+00:00,Nordrhein-Westfalen,71,95,671,39100,4.0
2020-06-12 00:00:00+00:00,Nordrhein-Westfalen,85,91,642,39185,4.0
2020-06-13 00:00:00+00:00,Nordrhein-Westfalen,110,93,657,39295,4.0
2020-06-14 00:00:00+00:00,Nordrhein-Westfalen,76,98,692,39371,4.0
2020-06-15 00:00:00+00:00,Nordrhein-Westfalen,97,101,707,39468,4.0
2020-06-16 00:00:00+00:00,Nordrhein-Westfalen,205,112,789,39673,4.0
2020-06-17 00:00:00+00:00,Nordrhein-Westfalen,608,178,1252,40281,7.0
2020-06-18 00:00:00+00:00,Nordrhein-Westfalen,221,200,1402,40502,8.0
2020-06-19 00:00:00+00:00,Nordrhein-Westfalen,521,262,1838,41023,10.0
2020-06-20 00:00:00+00:00,Nordrhein-Westfalen,336,294,2064,41359,12.0
2020-06-21 00:00:00+00:00,Nordrhein-Westfalen,153,305,2141,41512,12.0
2020-06-22 00:00:00+00:00,Nordrhein-Westfalen,249,327,2293,41761,13.0
2020-06-23 00:00:00+00:00,Nordrhein-Westfalen,222,330,2310,41983,13.0
2020-06-24 00:00:00+00:00,Nordrhein-Westfalen,240,277,1942,42223,11.0
2020-06-25 00:00:00+00:00,Nordrhein-Westfalen,277,285,1998,42500,11.0
2020-06-26 00:00:00+00:00,Nordrhein-Westfalen,256,247,1733,42756,10.0
2020-06-27 00:00:00+00:00,Nordrhein-Westfalen,158,222,1555,42914,9.0
2020-06-28 00:00:00+00:00,Nordrhein-Westfalen,117,217,1519,43031,8.0
2020-06-29 00:00:00+00:00,Nordrhein-Westfalen,202,210,1472,43233,8.0
2020-06-30 00:00:00+00:00,Nordrhein-Westfalen,177,203,1427,43410,8.0
2020-07-01 00:00:00+00:00,Nordrhein-Westfalen,176,194,1363,43586,8.0
2020-07-02 00:00:00+00:00,Nordrhein-Westfalen,204,184,1290,43790,7.0
2020-07-03 00:00:00+00:00,Nordrhein-Westfalen,170,172,1204,43960,7.0
2020-07-04 00:00:00+00:00,Nordrhein-Westfalen,121,166,1167,44081,7.0
2020-07-05 00:00:00+00:00,Nordrhein-Westfalen,59,158,1109,44140,6.0
2020-07-06 00:00:00+00:00,Nordrhein-Westfalen,86,141,993,44226,6.0
2020-07-07 00:00:00+00:00,Nordrhein-Westfalen,149,137,965,44375,5.0
2020-07-08 00:00:00+00:00,Nordrhein-Westfalen,181,138,970,44556,5.0
2020-07-09 00:00:00+00:00,Nordrhein-Westfalen,154,131,920,44710,5.0
2020-07-10 00:00:00+00:00,Nordrhein-Westfalen,171,131,921,44881,5.0
2020-07-11 00:00:00+00:00,Nordrhein-Westfalen,120,131,920,45001,5.0
2020-07-12 00:00:00+00:00,Nordrhein-Westfalen,63,132,924,45064,5.0
2020-07-13 00:00:00+00:00,Nordrhein-Westfalen,92,132,930,45156,5.0
2020-07-14 00:00:00+00:00,Nordrhein-Westfalen,158,134,939,45314,5.0
2020-07-15 00:00:00+00:00,Nordrhein-Westfalen,220,139,978,45534,5.0
2020-07-16 00:00:00+00:00,Nordrhein-Westfalen,258,154,1082,45792,6.0
2020-07-17 00:00:00+00:00,Nordrhein-Westfalen,198,158,1109,45990,6.0
2020-07-18 00:00:00+00:00,Nordrhein-Westfalen,156,163,1145,46146,6.0
2020-07-19 00:00:00+00:00,Nordrhein-Westfalen,58,162,1140,46204,6.0
2020-07-20 00:00:00+00:00,Nordrhein-Westfalen,158,172,1206,46362,7.0
2020-07-21 00:00:00+00:00,Nordrhein-Westfalen,186,176,1234,46548,7.0
2020-07-22 00:00:00+00:00,Nordrhein-Westfalen,265,182,1279,46813,7.0
2020-07-23 00:00:00+00:00,Nordrhein-Westfalen,297,188,1318,47110,7.0
2020-07-24 00:00:00+00:00,Nordrhein-Westfalen,308,204,1428,47418,8.0
2020-07-25 00:00:00+00:00,Nordrhein-Westfalen,197,209,1469,47615,8.0
2020-07-26 00:00:00+00:00,Nordrhein-Westfalen,59,210,1470,47674,8.0
2020-07-27 00:00:00+00:00,Nordrhein-Westfalen,168,211,1480,47842,8.0
2020-07-28 00:00:00+00:00,Nordrhein-Westfalen,286,225,1580,48128,9.0
2020-07-29 00:00:00+00:00,Nordrhein-Westfalen,364,239,1679,48492,9.0
2020-07-30 00:00:00+00:00,Nordrhein-Westfalen,351,247,1733,48843,10.0
2020-07-31 00:00:00+00:00,Nordrhein-Westfalen,355,254,1780,49198,10.0
2020-08-01 00:00:00+00:00,Nordrhein-Westfalen,224,258,1807,49422,10.0
2020-08-02 00:00:00+00:00,Nordrhein-Westfalen,155,271,1903,49577,11.0
2020-08-03 00:00:00+00:00,Nordrhein-Westfalen,295,290,2030,49872,11.0
2020-08-04 00:00:00+00:00,Nordrhein-Westfalen,376,302,2120,50248,12.0
2020-08-05 00:00:00+00:00,Nordrhein-Westfalen,450,315,2206,50698,12.0
2020-08-06 00:00:00+00:00,Nordrhein-Westfalen,431,326,2286,51129,13.0
2020-08-07 00:00:00+00:00,Nordrhein-Westfalen,359,327,2290,51488,13.0
2020-08-08 00:00:00+00:00,Nordrhein-Westfalen,334,342,2400,51822,13.0
2020-08-09 00:00:00+00:00,Nordrhein-Westfalen,179,346,2424,52001,14.0
2020-08-10 00:00:00+00:00,Nordrhein-Westfalen,353,354,2482,52354,14.0
2020-08-11 00:00:00+00:00,Nordrhein-Westfalen,433,362,2539,52787,14.0
2020-08-12 00:00:00+00:00,Nordrhein-Westfalen,559,378,2648,53346,15.0
2020-08-13 00:00:00+00:00,Nordrhein-Westfalen,536,393,2753,53882,15.0
2020-08-14 00:00:00+00:00,Nordrhein-Westfalen,498,413,2892,54380,16.0
2020-08-15 00:00:00+00:00,Nordrhein-Westfalen,326,412,2884,54706,16.0
2020-08-16 00:00:00+00:00,Nordrhein-Westfalen,172,411,2877,54878,16.0
2020-08-17 00:00:00+00:00,Nordrhein-Westfalen,383,415,2907,55261,16.0
2020-08-18 00:00:00+00:00,Nordrhein-Westfalen,368,406,2842,55629,16.0
2020-08-19 00:00:00+00:00,Nordrhein-Westfalen,383,380,2666,56012,15.0
2020-08-20 00:00:00+00:00,Nordrhein-Westfalen,361,355,2491,56373,14.0
2020-08-21 00:00:00+00:00,Nordrhein-Westfalen,446,348,2439,56819,14.0
2020-08-22 00:00:00+00:00,Nordrhein-Westfalen,195,329,2308,57014,13.0
2020-08-23 00:00:00+00:00,Nordrhein-Westfalen,156,327,2292,57170,13.0
2020-08-24 00:00:00+00:00,Nordrhein-Westfalen,278,312,2187,57448,12.0
2020-08-25 00:00:00+00:00,Nordrhein-Westfalen,281,300,2100,57729,12.0
2020-08-26 00:00:00+00:00,Nordrhein-Westfalen,310,289,2027,58039,11.0
2020-08-27 00:00:00+00:00,Nordrhein-Westfalen,311,282,1977,58350,11.0
2020-08-28 00:00:00+00:00,Nordrhein-Westfalen,258,255,1789,58608,10.0
2020-08-29 00:00:00+00:00,Nordrhein-Westfalen,162,250,1756,58770,10.0
2020-08-30 00:00:00+00:00,Nordrhein-Westfalen,136,248,1736,58906,10.0
2020-08-31 00:00:00+00:00,Nordrhein-Westfalen,252,244,1710,59158,10.0
2020-09-01 00:00:00+00:00,Nordrhein-Westfalen,249,239,1678,59407,9.0
2020-09-02 00:00:00+00:00,Nordrhein-Westfalen,282,235,1650,59689,9.0
2020-09-03 00:00:00+00:00,Nordrhein-Westfalen,305,234,1644,59994,9.0
2020-09-04 00:00:00+00:00,Nordrhein-Westfalen,289,239,1675,60283,9.0
2020-09-05 00:00:00+00:00,Nordrhein-Westfalen,212,246,1725,60495,10.0
2020-09-06 00:00:00+00:00,Nordrhein-Westfalen,110,242,1699,60605,9.0
2020-09-07 00:00:00+00:00,Nordrhein-Westfalen,224,238,1671,60829,9.0
2020-09-08 00:00:00+00:00,Nordrhein-Westfalen,213,233,1635,61042,9.0
2020-09-09 00:00:00+00:00,Nordrhein-Westfalen,346,242,1699,61388,9.0
2020-09-10 00:00:00+00:00,Nordrhein-Westfalen,320,244,1714,61708,10.0
2020-09-11 00:00:00+00:00,Nordrhein-Westfalen,389,259,1814,62097,10.0
2020-09-12 00:00:00+00:00,Nordrhein-Westfalen,323,275,1925,62420,11.0
2020-09-13 00:00:00+00:00,Nordrhein-Westfalen,189,286,2004,62609,11.0
2020-09-14 00:00:00+00:00,Nordrhein-Westfalen,371,307,2151,62980,12.0
2020-09-15 00:00:00+00:00,Nordrhein-Westfalen,396,333,2334,63376,13.0
2020-09-16 00:00:00+00:00,Nordrhein-Westfalen,472,351,2460,63848,14.0
2020-09-17 00:00:00+00:00,Nordrhein-Westfalen,602,391,2742,64450,15.0
2020-09-18 00:00:00+00:00,Nordrhein-Westfalen,536,412,2889,64986,16.0
2020-09-19 00:00:00+00:00,Nordrhein-Westfalen,399,423,2965,65385,17.0
2020-09-20 00:00:00+00:00,Nordrhein-Westfalen,180,422,2956,65565,16.0
2020-09-21 00:00:00+00:00,Nordrhein-Westfalen,424,429,3009,65989,17.0
2020-09-22 00:00:00+00:00,Nordrhein-Westfalen,456,438,3069,66445,17.0
2020-09-23 00:00:00+00:00,Nordrhein-Westfalen,536,447,3133,66981,17.0
2020-09-24 00:00:00+00:00,Nordrhein-Westfalen,611,448,3142,67592,18.0
2020-09-25 00:00:00+00:00,Nordrhein-Westfalen,631,462,3237,68223,18.0
2020-09-26 00:00:00+00:00,Nordrhein-Westfalen,563,485,3401,68786,19.0
2020-09-27 00:00:00+00:00,Nordrhein-Westfalen,327,506,3548,69113,20.0
2020-09-28 00:00:00+00:00,Nordrhein-Westfalen,440,509,3564,69553,20.0
2020-09-29 00:00:00+00:00,Nordrhein-Westfalen,602,530,3710,70155,21.0
2020-09-30 00:00:00+00:00,Nordrhein-Westfalen,759,561,3933,70914,22.0
2020-10-01 00:00:00+00:00,Nordrhein-Westfalen,849,595,4171,71763,23.0
2020-10-02 00:00:00+00:00,Nordrhein-Westfalen,742,611,4282,72505,24.0
2020-10-03 00:00:00+00:00,Nordrhein-Westfalen,660,625,4379,73165,24.0
2020-10-04 00:00:00+00:00,Nordrhein-Westfalen,337,627,4389,73502,24.0
2020-10-05 00:00:00+00:00,Nordrhein-Westfalen,706,665,4655,74208,26.0
2020-10-06 00:00:00+00:00,Nordrhein-Westfalen,841,699,4894,75049,27.0
2020-10-07 00:00:00+00:00,Nordrhein-Westfalen,1190,760,5325,76239,30.0
2020-10-08 00:00:00+00:00,Nordrhein-Westfalen,1278,822,5754,77517,32.0
2020-10-09 00:00:00+00:00,Nordrhein-Westfalen,1414,918,6426,78931,36.0
2020-10-10 00:00:00+00:00,Nordrhein-Westfalen,1059,975,6825,79990,38.0
2020-10-11 00:00:00+00:00,Nordrhein-Westfalen,746,1033,7234,80736,40.0
2020-10-12 00:00:00+00:00,Nordrhein-Westfalen,923,1064,7451,81659,42.0
2020-10-13 00:00:00+00:00,Nordrhein-Westfalen,1328,1134,7938,82987,44.0
2020-10-14 00:00:00+00:00,Nordrhein-Westfalen,1955,1243,8703,84942,48.0
2020-10-15 00:00:00+00:00,Nordrhein-Westfalen,2064,1355,9489,87006,53.0
2020-10-16 00:00:00+00:00,Nordrhein-Westfalen,2022,1442,10097,89028,56.0
2020-10-17 00:00:00+00:00,Nordrhein-Westfalen,1618,1522,10656,90646,59.0
2020-10-18 00:00:00+00:00,Nordrhein-Westfalen,1177,1583,11087,91823,62.0
2020-10-19 00:00:00+00:00,Nordrhein-Westfalen,1518,1668,11682,93341,65.0
2020-10-20 00:00:00+00:00,Nordrhein-Westfalen,2208,1794,12562,95549,70.0
2020-10-21 00:00:00+00:00,Nordrhein-Westfalen,3036,1949,13643,98585,76.0
2020-10-22 00:00:00+00:00,Nordrhein-Westfalen,3899,2211,15478,102484,86.0
2020-10-23 00:00:00+00:00,Nordrhein-Westfalen,3837,2470,17293,106321,96.0
2020-10-24 00:00:00+00:00,Nordrhein-Westfalen,3514,2741,19189,109835,107.0
2020-10-25 00:00:00+00:00,Nordrhein-Westfalen,2534,2935,20546,112369,114.0
2020-10-26 00:00:00+00:00,Nordrhein-Westfalen,2755,3111,21783,115124,121.0
2020-10-27 00:00:00+00:00,Nordrhein-Westfalen,3695,3324,23270,118819,130.0
2020-10-28 00:00:00+00:00,Nordrhein-Westfalen,4896,3590,25130,123715,140.0
2020-10-29 00:00:00+00:00,Nordrhein-Westfalen,5818,3864,27049,129533,151.0
2020-10-30 00:00:00+00:00,Nordrhein-Westfalen,5211,4060,28423,134744,158.0
2020-10-31 00:00:00+00:00,Nordrhein-Westfalen,3896,4115,28805,138640,160.0
2020-11-01 00:00:00+00:00,Nordrhein-Westfalen,3220,4213,29491,141860,164.0
2020-11-02 00:00:00+00:00,Nordrhein-Westfalen,3852,4369,30588,145712,170.0
2020-11-03 00:00:00+00:00,Nordrhein-Westfalen,4676,4509,31569,150388,176.0
2020-11-04 00:00:00+00:00,Nordrhein-Westfalen,5180,4550,31853,155568,177.0
2020-11-05 00:00:00+00:00,Nordrhein-Westfalen,5867,4557,31902,161435,178.0
2020-11-06 00:00:00+00:00,Nordrhein-Westfalen,5152,4549,31843,166587,177.0
2020-11-07 00:00:00+00:00,Nordrhein-Westfalen,3771,4531,31718,170358,177.0
2020-11-08 00:00:00+00:00,Nordrhein-Westfalen,2943,4491,31441,173301,175.0
2020-11-09 00:00:00+00:00,Nordrhein-Westfalen,4107,4528,31696,177408,177.0
2020-11-10 00:00:00+00:00,Nordrhein-Westfalen,4325,4477,31345,181733,175.0
2020-11-11 00:00:00+00:00,Nordrhein-Westfalen,5155,4474,31320,186888,175.0
2020-11-12 00:00:00+00:00,Nordrhein-Westfalen,5740,4456,31193,192628,174.0
2020-11-13 00:00:00+00:00,Nordrhein-Westfalen,5129,4452,31170,197757,174.0
2020-11-14 00:00:00+00:00,Nordrhein-Westfalen,4199,4514,31598,201956,176.0
2020-11-15 00:00:00+00:00,Nordrhein-Westfalen,2355,4430,31010,204311,173.0
2020-11-16 00:00:00+00:00,Nordrhein-Westfalen,3935,4405,30838,208246,172.0
2020-11-17 00:00:00+00:00,Nordrhein-Westfalen,4338,4407,30851,212584,172.0
2020-11-18 00:00:00+00:00,Nordrhein-Westfalen,5525,4460,31221,218109,174.0
2020-11-19 00:00:00+00:00,Nordrhein-Westfalen,5716,4456,31197,223825,174.0
2020-11-20 00:00:00+00:00,Nordrhein-Westfalen,5064,4447,31132,228889,173.0
2020-11-21 00:00:00+00:00,Nordrhein-Westfalen,3155,4298,30088,232044,168.0
2020-11-22 00:00:00+00:00,Nordrhein-Westfalen,1995,4246,29728,234039,166.0
2020-11-23 00:00:00+00:00,Nordrhein-Westfalen,3928,4245,29721,237967,166.0
2020-11-24 00:00:00+00:00,Nordrhein-Westfalen,4278,4237,29661,242245,165.0
2020-11-25 00:00:00+00:00,Nordrhein-Westfalen,4923,4151,29059,247168,162.0
2020-11-26 00:00:00+00:00,Nordrhein-Westfalen,4629,3996,27972,251797,156.0
2020-11-27 00:00:00+00:00,Nordrhein-Westfalen,4382,3898,27290,256179,152.0
2020-11-28 00:00:00+00:00,Nordrhein-Westfalen,3441,3939,27576,259620,154.0
2020-11-29 00:00:00+00:00,Nordrhein-Westfalen,1938,3931,27519,261558,153.0
2020-11-30 00:00:00+00:00,Nordrhein-Westfalen,2686,3753,26277,264244,146.0
2020-12-01 00:00:00+00:00,Nordrhein-Westfalen,3881,3697,25880,268125,144.0
2020-12-02 00:00:00+00:00,Nordrhein-Westfalen,4860,3688,25817,272985,144.0
2020-12-03 00:00:00+00:00,Nordrhein-Westfalen,4771,3708,25959,277756,145.0
2020-12-04 00:00:00+00:00,Nordrhein-Westfalen,4511,3726,26088,282267,145.0
2020-12-05 00:00:00+00:00,Nordrhein-Westfalen,3398,3720,26045,285665,145.0
2020-12-06 00:00:00+00:00,Nordrhein-Westfalen,2069,3739,26176,287734,146.0
2020-12-07 00:00:00+00:00,Nordrhein-Westfalen,3357,3835,26847,291091,150.0
2020-12-08 00:00:00+00:00,Nordrhein-Westfalen,4525,3927,27491,295616,153.0
2020-12-09 00:00:00+00:00,Nordrhein-Westfalen,5306,3991,27937,300922,156.0
2020-12-10 00:00:00+00:00,Nordrhein-Westfalen,5789,4136,28955,306711,161.0
2020-12-11 00:00:00+00:00,Nordrhein-Westfalen,5866,4330,30310,312577,169.0
2020-12-12 00:00:00+00:00,Nordrhein-Westfalen,4130,4434,31042,316707,173.0
2020-12-13 00:00:00+00:00,Nordrhein-Westfalen,2527,4500,31500,319234,176.0
2020-12-14 00:00:00+00:00,Nordrhein-Westfalen,3712,4550,31855,322946,177.0
2020-12-15 00:00:00+00:00,Nordrhein-Westfalen,5174,4643,32504,328120,181.0
2020-12-16 00:00:00+00:00,Nordrhein-Westfalen,6141,4762,33339,334261,186.0
2020-12-17 00:00:00+00:00,Nordrhein-Westfalen,6204,4822,33754,340465,188.0
2020-12-18 00:00:00+00:00,Nordrhein-Westfalen,5919,4829,33807,346384,188.0
2020-12-19 00:00:00+00:00,Nordrhein-Westfalen,4401,4868,34078,350785,190.0
2020-12-20 00:00:00+00:00,Nordrhein-Westfalen,2964,4930,34515,353749,192.0
2020-12-21 00:00:00+00:00,Nordrhein-Westfalen,4081,4983,34884,357830,194.0
2020-12-22 00:00:00+00:00,Nordrhein-Westfalen,5587,5042,35297,363417,197.0
2020-12-23 00:00:00+00:00,Nordrhein-Westfalen,6803,5137,35959,370220,200.0
2020-12-24 00:00:00+00:00,Nordrhein-Westfalen,3810,4795,33565,374030,187.0
2020-12-25 00:00:00+00:00,Nordrhein-Westfalen,2225,4267,29871,376255,166.0
2020-12-26 00:00:00+00:00,Nordrhein-Westfalen,2062,3933,27532,378317,153.0
2020-12-27 00:00:00+00:00,Nordrhein-Westfalen,2296,3837,26864,380613,150.0
2020-12-28 00:00:00+00:00,Nordrhein-Westfalen,2612,3627,25395,383225,141.0
2020-12-29 00:00:00+00:00,Nordrhein-Westfalen,4881,3527,24689,388106,138.0
2020-12-30 00:00:00+00:00,Nordrhein-Westfalen,5796,3383,23682,393902,132.0
2020-12-31 00:00:00+00:00,Nordrhein-Westfalen,3151,3289,23023,397053,128.0
2021-01-01 00:00:00+00:00,Nordrhein-Westfalen,1703,3214,22501,398756,125.0
2021-01-02 00:00:00+00:00,Nordrhein-Westfalen,1901,3191,22340,400657,124.0
2021-01-03 00:00:00+00:00,Nordrhein-Westfalen,1802,3120,21846,402459,122.0
2021-01-04 00:00:00+00:00,Nordrhein-Westfalen,2452,3098,21686,404911,121.0
2021-01-05 00:00:00+00:00,Nordrhein-Westfalen,4893,3099,21698,409804,121.0
2021-01-06 00:00:00+00:00,Nordrhein-Westfalen,5999,3128,21901,415803,122.0
2021-01-07 00:00:00+00:00,Nordrhein-Westfalen,5011,3394,23761,420814,132.0
2021-01-08 00:00:00+00:00,Nordrhein-Westfalen,4314,3767,26372,425128,147.0
2021-01-09 00:00:00+00:00,Nordrhein-Westfalen,3069,3934,27540,428197,153.0
2021-01-10 00:00:00+00:00,Nordrhein-Westfalen,1537,3896,27275,429734,152.0
2021-01-11 00:00:00+00:00,Nordrhein-Westfalen,2233,3865,27056,431967,151.0
2021-01-12 00:00:00+00:00,Nordrhein-Westfalen,4056,3745,26219,436023,146.0
2021-01-13 00:00:00+00:00,Nordrhein-Westfalen,4318,3505,24538,440341,137.0
2021-01-14 00:00:00+00:00,Nordrhein-Westfalen,3983,3358,23510,444324,131.0
2021-01-15 00:00:00+00:00,Nordrhein-Westfalen,3521,3245,22717,447845,127.0
2021-01-16 00:00:00+00:00,Nordrhein-Westfalen,2803,3207,22451,450648,125.0
2021-01-17 00:00:00+00:00,Nordrhein-Westfalen,1146,3151,22060,451794,123.0
2021-01-18 00:00:00+00:00,Nordrhein-Westfalen,1719,3078,21546,453513,120.0
2021-01-19 00:00:00+00:00,Nordrhein-Westfalen,3455,2992,20945,456968,117.0
2021-01-20 00:00:00+00:00,Nordrhein-Westfalen,3962,2941,20589,460930,115.0
2021-01-21 00:00:00+00:00,Nordrhein-Westfalen,3271,2839,19877,464201,111.0
2021-01-22 00:00:00+00:00,Nordrhein-Westfalen,3119,2782,19475,467320,109.0
2021-01-23 00:00:00+00:00,Nordrhein-Westfalen,2533,2743,19205,469853,107.0
2021-01-24 00:00:00+00:00,Nordrhein-Westfalen,901,2708,18960,470754,106.0
2021-01-25 00:00:00+00:00,Nordrhein-Westfalen,1453,2670,18694,472207,104.0
2021-01-26 00:00:00+00:00,Nordrhein-Westfalen,2728,2566,17967,474935,100.0
2021-01-27 00:00:00+00:00,Nordrhein-Westfalen,3060,2437,17065,477995,95.0
2021-01-28 00:00:00+00:00,Nordrhein-Westfalen,2677,2353,16471,480672,92.0
2021-01-29 00:00:00+00:00,Nordrhein-Westfalen,2587,2277,15939,483259,89.0
2021-01-30 00:00:00+00:00,Nordrhein-Westfalen,2125,2218,15531,485384,87.0
2021-01-31 00:00:00+00:00,Nordrhein-Westfalen,959,2227,15589,486343,87.0
2021-02-01 00:00:00+00:00,Nordrhein-Westfalen,1139,2182,15275,487482,85.0
2021-02-02 00:00:00+00:00,Nordrhein-Westfalen,2257,2114,14804,489739,82.0
2021-02-03 00:00:00+00:00,Nordrhein-Westfalen,2651,2056,14395,492390,80.0
2021-02-04 00:00:00+00:00,Nordrhein-Westfalen,2467,2026,14185,494857,79.0
2021-02-05 00:00:00+00:00,Nordrhein-Westfalen,2132,1961,13730,496989,77.0
2021-02-06 00:00:00+00:00,Nordrhein-Westfalen,1810,1916,13415,498799,75.0
2021-02-07 00:00:00+00:00,Nordrhein-Westfalen,594,1864,13050,499393,73.0
2021-02-08 00:00:00+00:00,Nordrhein-Westfalen,831,1820,12742,500224,71.0
2021-02-09 00:00:00+00:00,Nordrhein-Westfalen,1721,1743,12206,501945,68.0
2021-02-10 00:00:00+00:00,Nordrhein-Westfalen,1899,1636,11454,503844,64.0
2021-02-11 00:00:00+00:00,Nordrhein-Westfalen,1881,1552,10868,505725,61.0
2021-02-12 00:00:00+00:00,Nordrhein-Westfalen,1739,1496,10475,507464,58.0
2021-02-13 00:00:00+00:00,Nordrhein-Westfalen,1313,1425,9978,508777,56.0
2021-02-14 00:00:00+00:00,Nordrhein-Westfalen,788,1453,10172,509565,57.0
2021-02-15 00:00:00+00:00,Nordrhein-Westfalen,827,1452,10168,510392,57.0
2021-02-16 00:00:00+00:00,Nordrhein-Westfalen,1834,1468,10281,512226,57.0
2021-02-17 00:00:00+00:00,Nordrhein-Westfalen,2092,1496,10474,514318,58.0
2021-02-18 00:00:00+00:00,Nordrhein-Westfalen,2064,1522,10657,516382,59.0
2021-02-19 00:00:00+00:00,Nordrhein-Westfalen,1837,1536,10755,518219,60.0
2021-02-20 00:00:00+00:00,Nordrhein-Westfalen,1741,1597,11183,519960,62.0
2021-02-21 00:00:00+00:00,Nordrhein-Westfalen,739,1590,11134,520699,62.0
2021-02-22 00:00:00+00:00,Nordrhein-Westfalen,807,1587,11114,521506,62.0
2021-02-23 00:00:00+00:00,Nordrhein-Westfalen,1955,1605,11235,523461,63.0
2021-02-24 00:00:00+00:00,Nordrhein-Westfalen,2681,1689,11824,526142,66.0
2021-02-25 00:00:00+00:00,Nordrhein-Westfalen,1997,1679,11757,528139,66.0
2021-02-26 00:00:00+00:00,Nordrhein-Westfalen,1888,1686,11808,530027,66.0
2021-02-27 00:00:00+00:00,Nordrhein-Westfalen,1614,1668,11681,531641,65.0
2021-02-28 00:00:00+00:00,Nordrhein-Westfalen,730,1667,11672,532371,65.0
2021-03-01 00:00:00+00:00,Nordrhein-Westfalen,908,1681,11773,533279,66.0
2021-03-02 00:00:00+00:00,Nordrhein-Westfalen,2254,1724,12072,535533,67.0
2021-03-03 00:00:00+00:00,Nordrhein-Westfalen,2186,1653,11577,537719,65.0
2021-03-04 00:00:00+00:00,Nordrhein-Westfalen,2166,1678,11746,539885,65.0
2021-03-05 00:00:00+00:00,Nordrhein-Westfalen,2001,1694,11859,541886,66.0
2021-03-06 00:00:00+00:00,Nordrhein-Westfalen,1764,1715,12009,543650,67.0
2021-03-07 00:00:00+00:00,Nordrhein-Westfalen,723,1714,12002,544373,67.0
2021-03-08 00:00:00+00:00,Nordrhein-Westfalen,946,1720,12040,545319,67.0
2021-03-09 00:00:00+00:00,Nordrhein-Westfalen,2385,1738,12171,547704,68.0
2021-03-10 00:00:00+00:00,Nordrhein-Westfalen,2894,1839,12879,550598,72.0
2021-03-11 00:00:00+00:00,Nordrhein-Westfalen,2732,1920,13445,553330,75.0
2021-03-12 00:00:00+00:00,Nordrhein-Westfalen,2616,2008,14060,555946,78.0
2021-03-13 00:00:00+00:00,Nordrhein-Westfalen,2196,2070,14492,558142,81.0
2021-03-14 00:00:00+00:00,Nordrhein-Westfalen,1066,2119,14835,559208,83.0
2021-03-15 00:00:00+00:00,Nordrhein-Westfalen,1318,2172,15207,560526,85.0
2021-03-16 00:00:00+00:00,Nordrhein-Westfalen,3101,2274,15923,563627,89.0
2021-03-17 00:00:00+00:00,Nordrhein-Westfalen,4166,2456,17195,567793,96.0
2021-03-18 00:00:00+00:00,Nordrhein-Westfalen,3454,2559,17917,571247,100.0
2021-03-19 00:00:00+00:00,Nordrhein-Westfalen,3314,2659,18615,574561,104.0
2021-03-20 00:00:00+00:00,Nordrhein-Westfalen,2767,2740,19186,577328,107.0
2021-03-21 00:00:00+00:00,Nordrhein-Westfalen,1392,2787,19512,578720,109.0
2021-03-22 00:00:00+00:00,Nordrhein-Westfalen,2002,2885,20196,580722,113.0
2021-03-23 00:00:00+00:00,Nordrhein-Westfalen,3738,2976,20833,584460,116.0
2021-03-24 00:00:00+00:00,Nordrhein-Westfalen,4781,3064,21448,589241,120.0
2021-03-25 00:00:00+00:00,Nordrhein-Westfalen,4735,3247,22729,593976,127.0
2021-03-26 00:00:00+00:00,Nordrhein-Westfalen,3907,3331,23322,597883,130.0
2021-03-27 00:00:00+00:00,Nordrhein-Westfalen,3291,3406,23846,601174,133.0
2021-03-28 00:00:00+00:00,Nordrhein-Westfalen,1583,3433,24037,602757,134.0
2021-03-29 00:00:00+00:00,Nordrhein-Westfalen,2494,3504,24529,605251,137.0
2021-03-30 00:00:00+00:00,Nordrhein-Westfalen,3898,3527,24689,609149,138.0
2021-03-31 00:00:00+00:00,Nordrhein-Westfalen,4780,3526,24688,613929,138.0
2021-04-01 00:00:00+00:00,Nordrhein-Westfalen,4386,3477,24339,618315,136.0
2021-04-02 00:00:00+00:00,Nordrhein-Westfalen,3350,3397,23782,621665,133.0
2021-04-03 00:00:00+00:00,Nordrhein-Westfalen,2530,3288,23021,624195,128.0
2021-04-04 00:00:00+00:00,Nordrhein-Westfalen,1352,3255,22790,625547,127.0
2021-04-05 00:00:00+00:00,Nordrhein-Westfalen,1963,3179,22259,627510,124.0
2021-04-06 00:00:00+00:00,Nordrhein-Westfalen,2372,2961,20733,629882,116.0
2021-04-07 00:00:00+00:00,Nordrhein-Westfalen,4481,2919,20434,634363,114.0
2021-04-08 00:00:00+00:00,Nordrhein-Westfalen,4947,2999,20995,639310,117.0
2021-04-09 00:00:00+00:00,Nordrhein-Westfalen,4855,3214,22500,644165,125.0
2021-04-10 00:00:00+00:00,Nordrhein-Westfalen,3950,3417,23920,648115,133.0
2021-04-11 00:00:00+00:00,Nordrhein-Westfalen,2080,3521,24648,650195,137.0
2021-04-12 00:00:00+00:00,Nordrhein-Westfalen,2764,3635,25449,652959,142.0
2021-04-13 00:00:00+00:00,Nordrhein-Westfalen,5673,4107,28750,658632,160.0
2021-04-14 00:00:00+00:00,Nordrhein-Westfalen,6199,4352,30468,664831,170.0
2021-04-15 00:00:00+00:00,Nordrhein-Westfalen,5565,4440,31086,670396,173.0
2021-04-16 00:00:00+00:00,Nordrhein-Westfalen,5225,4493,31456,675621,175.0
2021-04-17 00:00:00+00:00,Nordrhein-Westfalen,4350,4550,31856,679971,177.0
2021-04-18 00:00:00+00:00,Nordrhein-Westfalen,2328,4586,32104,682299,179.0
2021-04-19 00:00:00+00:00,Nordrhein-Westfalen,2990,4618,32330,685289,180.0
2021-04-20 00:00:00+00:00,Nordrhein-Westfalen,6329,4712,32986,691618,184.0
2021-04-21 00:00:00+00:00,Nordrhein-Westfalen,6684,4781,33471,698302,186.0
2021-04-22 00:00:00+00:00,Nordrhein-Westfalen,6435,4905,34341,704737,191.0
2021-04-23 00:00:00+00:00,Nordrhein-Westfalen,5594,4958,34710,710331,193.0
2021-04-24 00:00:00+00:00,Nordrhein-Westfalen,4189,4935,34549,714520,193.0
2021-04-25 00:00:00+00:00,Nordrhein-Westfalen,2118,4905,34339,716638,191.0
2021-04-26 00:00:00+00:00,Nordrhein-Westfalen,3090,4919,34439,719728,192.0
2021-04-27 00:00:00+00:00,Nordrhein-Westfalen,5078,4741,33188,724806,185.0
2021-04-28 00:00:00+00:00,Nordrhein-Westfalen,5613,4588,32117,730419,179.0
2021-04-29 00:00:00+00:00,Nordrhein-Westfalen,5163,4406,30845,735582,172.0
2021-04-30 00:00:00+00:00,Nordrhein-Westfalen,4448,4242,29699,740030,165.0
2021-05-01 00:00:00+00:00,Nordrhein-Westfalen,3814,4189,29324,743844,163.0
2021-05-02 00:00:00+00:00,Nordrhein-Westfalen,1784,4141,28990,745628,162.0
2021-05-03 00:00:00+00:00,Nordrhein-Westfalen,2473,4053,28373,748101,158.0
2021-05-04 00:00:00+00:00,Nordrhein-Westfalen,4360,3950,27655,752461,154.0
2021-05-05 00:00:00+00:00,Nordrhein-Westfalen,4776,3831,26818,757237,149.0
2021-05-06 00:00:00+00:00,Nordrhein-Westfalen,3914,3652,25569,761151,142.0
2021-05-07 00:00:00+00:00,Nordrhein-Westfalen,3642,3537,24763,764793,138.0
2021-05-08 00:00:00+00:00,Nordrhein-Westfalen,2826,3396,23775,767619,132.0
2021-05-09 00:00:00+00:00,Nordrhein-Westfalen,1446,3348,23437,769065,131.0
2021-05-10 00:00:00+00:00,Nordrhein-Westfalen,1743,3243,22707,770808,127.0
2021-05-11 00:00:00+00:00,Nordrhein-Westfalen,3429,3110,21776,774237,121.0
2021-05-12 00:00:00+00:00,Nordrhein-Westfalen,3637,2948,20637,777874,115.0
2021-05-13 00:00:00+00:00,Nordrhein-Westfalen,2220,2706,18943,780094,106.0
2021-05-14 00:00:00+00:00,Nordrhein-Westfalen,1838,2448,17139,781932,95.0
2021-05-15 00:00:00+00:00,Nordrhein-Westfalen,2347,2380,16660,784279,93.0
2021-05-16 00:00:00+00:00,Nordrhein-Westfalen,1242,2350,16456,785521,92.0
2021-05-17 00:00:00+00:00,Nordrhein-Westfalen,1179,2270,15892,786700,89.0
2021-05-18 00:00:00+00:00,Nordrhein-Westfalen,2540,2143,15003,789240,84.0
2021-05-19 00:00:00+00:00,Nordrhein-Westfalen,2484,1978,13850,791724,77.0
2021-05-20 00:00:00+00:00,Nordrhein-Westfalen,2002,1947,13632,793726,76.0
2021-05-21 00:00:00+00:00,Nordrhein-Westfalen,1844,1948,13638,795570,76.0
2021-05-22 00:00:00+00:00,Nordrhein-Westfalen,1349,1805,12640,796919,70.0
2021-05-23 00:00:00+00:00,Nordrhein-Westfalen,516,1702,11914,797435,66.0
2021-05-24 00:00:00+00:00,Nordrhein-Westfalen,558,1613,11293,797993,63.0
2021-05-25 00:00:00+00:00,Nordrhein-Westfalen,831,1369,9584,798824,53.0
2021-05-26 00:00:00+00:00,Nordrhein-Westfalen,1566,1238,8666,800390,48.0
2021-05-27 00:00:00+00:00,Nordrhein-Westfalen,1700,1194,8364,802090,47.0
2021-05-28 00:00:00+00:00,Nordrhein-Westfalen,1237,1108,7757,803327,43.0
2021-05-29 00:00:00+00:00,Nordrhein-Westfalen,1029,1062,7437,804356,41.0
2021-05-30 00:00:00+00:00,Nordrhein-Westfalen,427,1049,7348,804783,41.0
2021-05-31 00:00:00+00:00,Nordrhein-Westfalen,620,1058,7410,805403,41.0
2021-06-01 00:00:00+00:00,Nordrhein-Westfalen,1241,1117,7820,806644,44.0
2021-06-02 00:00:00+00:00,Nordrhein-Westfalen,1139,1056,7393,807783,41.0
2021-06-03 00:00:00+00:00,Nordrhein-Westfalen,617,901,6310,808400,35.0
2021-06-04 00:00:00+00:00,Nordrhein-Westfalen,611,812,5684,809011,32.0
2021-06-05 00:00:00+00:00,Nordrhein-Westfalen,506,737,5161,809517,29.0
2021-06-06 00:00:00+00:00,Nordrhein-Westfalen,307,720,5041,809824,28.0
2021-06-07 00:00:00+00:00,Nordrhein-Westfalen,409,690,4830,810233,27.0
2021-06-08 00:00:00+00:00,Nordrhein-Westfalen,790,625,4379,811023,24.0
2021-06-09 00:00:00+00:00,Nordrhein-Westfalen,650,555,3890,811673,22.0
2021-06-10 00:00:00+00:00,Nordrhein-Westfalen,551,546,3824,812224,21.0
2021-06-11 00:00:00+00:00,Nordrhein-Westfalen,436,521,3649,812660,20.0
2021-06-12 00:00:00+00:00,Nordrhein-Westfalen,290,490,3433,812950,19.0
2021-06-13 00:00:00+00:00,Nordrhein-Westfalen,133,465,3259,813083,18.0
2021-06-14 00:00:00+00:00,Nordrhein-Westfalen,283,447,3133,813366,17.0
2021-06-15 00:00:00+00:00,Nordrhein-Westfalen,341,383,2684,813707,15.0
2021-06-16 00:00:00+00:00,Nordrhein-Westfalen,312,335,2346,814019,13.0
2021-06-17 00:00:00+00:00,Nordrhein-Westfalen,273,295,2068,814292,12.0
2021-06-18 00:00:00+00:00,Nordrhein-Westfalen,210,263,1842,814502,10.0
2021-06-19 00:00:00+00:00,Nordrhein-Westfalen,181,247,1733,814683,10.0
2021-06-20 00:00:00+00:00,Nordrhein-Westfalen,63,237,1663,814746,9.0
2021-06-21 00:00:00+00:00,Nordrhein-Westfalen,133,216,1513,814879,8.0
2021-06-22 00:00:00+00:00,Nordrhein-Westfalen,202,196,1374,815081,8.0
2021-06-23 00:00:00+00:00,Nordrhein-Westfalen,194,179,1256,815275,7.0
2021-06-24 00:00:00+00:00,Nordrhein-Westfalen,198,168,1181,815473,7.0
2021-06-25 00:00:00+00:00,Nordrhein-Westfalen,169,162,1140,815642,6.0
2021-06-26 00:00:00+00:00,Nordrhein-Westfalen,131,155,1090,815773,6.0
2021-06-27 00:00:00+00:00,Nordrhein-Westfalen,39,152,1066,815812,6.0
2021-06-28 00:00:00+00:00,Nordrhein-Westfalen,107,148,1040,815919,6.0
2021-06-29 00:00:00+00:00,Nordrhein-Westfalen,208,149,1046,816127,6.0
2021-06-30 00:00:00+00:00,Nordrhein-Westfalen,230,154,1082,816357,6.0
2021-07-01 00:00:00+00:00,Nordrhein-Westfalen,153,148,1037,816510,6.0
2021-07-02 00:00:00+00:00,Nordrhein-Westfalen,137,143,1005,816647,6.0
2021-07-03 00:00:00+00:00,Nordrhein-Westfalen,145,145,1019,816792,6.0
2021-07-04 00:00:00+00:00,Nordrhein-Westfalen,71,150,1051,816863,6.0
2021-07-05 00:00:00+00:00,Nordrhein-Westfalen,102,149,1046,816965,6.0
2021-07-06 00:00:00+00:00,Nordrhein-Westfalen,196,147,1034,817161,6.0
2020-01-23 00:00:00+00:00,Baden-Württemberg,1,0,0,1,0.0
2020-02-24 00:00:00+00:00,Baden-Württemberg,1,0,0,2,0.0
2020-02-25 00:00:00+00:00,Baden-Württemberg,2,0,0,4,0.0
2020-02-26 00:00:00+00:00,Baden-Württemberg,4,0,0,8,0.0
2020-02-27 00:00:00+00:00,Baden-Württemberg,3,0,0,11,0.0
2020-02-28 00:00:00+00:00,Baden-Württemberg,7,0,0,18,0.0
2020-02-29 00:00:00+00:00,Baden-Württemberg,2,2,20,20,0.0
2020-03-01 00:00:00+00:00,Baden-Württemberg,1,2,20,21,0.0
2020-03-02 00:00:00+00:00,Baden-Württemberg,9,4,28,30,0.0
2020-03-03 00:00:00+00:00,Baden-Württemberg,24,7,50,54,0.0
2020-03-04 00:00:00+00:00,Baden-Württemberg,38,12,84,92,1.0
2020-03-05 00:00:00+00:00,Baden-Württemberg,36,16,117,128,1.0
2020-03-06 00:00:00+00:00,Baden-Württemberg,51,23,161,179,1.0
2020-03-07 00:00:00+00:00,Baden-Württemberg,32,27,191,211,2.0
2020-03-08 00:00:00+00:00,Baden-Württemberg,18,29,208,229,2.0
2020-03-09 00:00:00+00:00,Baden-Württemberg,51,35,250,280,2.0
2020-03-10 00:00:00+00:00,Baden-Württemberg,115,48,341,395,3.0
2020-03-11 00:00:00+00:00,Baden-Württemberg,147,64,450,542,4.0
2020-03-12 00:00:00+00:00,Baden-Württemberg,189,86,603,731,5.0
2020-03-13 00:00:00+00:00,Baden-Württemberg,313,123,865,1044,8.0
2020-03-14 00:00:00+00:00,Baden-Württemberg,324,165,1157,1368,10.0
2020-03-15 00:00:00+00:00,Baden-Württemberg,184,189,1323,1552,12.0
2020-03-16 00:00:00+00:00,Baden-Württemberg,430,243,1702,1982,15.0
2020-03-17 00:00:00+00:00,Baden-Württemberg,593,311,2180,2575,20.0
2020-03-18 00:00:00+00:00,Baden-Württemberg,800,404,2833,3375,26.0
2020-03-19 00:00:00+00:00,Baden-Württemberg,654,471,3298,4029,30.0
2020-03-20 00:00:00+00:00,Baden-Württemberg,842,546,3827,4871,34.0
2020-03-21 00:00:00+00:00,Baden-Württemberg,565,581,4068,5436,37.0
2020-03-22 00:00:00+00:00,Baden-Württemberg,545,632,4429,5981,40.0
2020-03-23 00:00:00+00:00,Baden-Württemberg,652,664,4651,6633,42.0
2020-03-24 00:00:00+00:00,Baden-Württemberg,1187,749,5245,7820,47.0
2020-03-25 00:00:00+00:00,Baden-Württemberg,1184,804,5629,9004,51.0
2020-03-26 00:00:00+00:00,Baden-Württemberg,1220,885,6195,10224,56.0
2020-03-27 00:00:00+00:00,Baden-Württemberg,1244,942,6597,11468,59.0
2020-03-28 00:00:00+00:00,Baden-Württemberg,1007,1005,7039,12475,63.0
2020-03-29 00:00:00+00:00,Baden-Württemberg,656,1021,7150,13131,64.0
2020-03-30 00:00:00+00:00,Baden-Württemberg,931,1061,7429,14062,67.0
2020-03-31 00:00:00+00:00,Baden-Württemberg,1226,1066,7468,15288,67.0
2020-04-01 00:00:00+00:00,Baden-Württemberg,1238,1074,7522,16526,68.0
2020-04-02 00:00:00+00:00,Baden-Württemberg,1417,1102,7719,17943,70.0
2020-04-03 00:00:00+00:00,Baden-Württemberg,1272,1106,7747,19215,70.0
2020-04-04 00:00:00+00:00,Baden-Württemberg,860,1085,7600,20075,68.0
2020-04-05 00:00:00+00:00,Baden-Württemberg,496,1062,7440,20571,67.0
2020-04-06 00:00:00+00:00,Baden-Württemberg,563,1010,7072,21134,64.0
2020-04-07 00:00:00+00:00,Baden-Württemberg,904,964,6750,22038,61.0
2020-04-08 00:00:00+00:00,Baden-Württemberg,931,920,6443,22969,58.0
2020-04-09 00:00:00+00:00,Baden-Württemberg,998,860,6024,23967,54.0
2020-04-10 00:00:00+00:00,Baden-Württemberg,664,773,5416,24631,49.0
2020-04-11 00:00:00+00:00,Baden-Württemberg,751,758,5307,25382,48.0
2020-04-12 00:00:00+00:00,Baden-Württemberg,425,748,5236,25807,47.0
2020-04-13 00:00:00+00:00,Baden-Württemberg,291,709,4964,26098,45.0
2020-04-14 00:00:00+00:00,Baden-Württemberg,371,633,4431,26469,40.0
2020-04-15 00:00:00+00:00,Baden-Württemberg,621,588,4121,27090,37.0
2020-04-16 00:00:00+00:00,Baden-Württemberg,662,540,3785,27752,34.0
2020-04-17 00:00:00+00:00,Baden-Württemberg,554,525,3675,28306,33.0
2020-04-18 00:00:00+00:00,Baden-Württemberg,387,473,3311,28693,30.0
2020-04-19 00:00:00+00:00,Baden-Württemberg,297,454,3183,28990,29.0
2020-04-20 00:00:00+00:00,Baden-Württemberg,276,452,3168,29266,29.0
2020-04-21 00:00:00+00:00,Baden-Württemberg,391,455,3188,29657,29.0
2020-04-22 00:00:00+00:00,Baden-Württemberg,503,438,3070,30160,28.0
2020-04-23 00:00:00+00:00,Baden-Württemberg,423,404,2831,30583,26.0
2020-04-24 00:00:00+00:00,Baden-Württemberg,361,376,2638,30944,24.0
2020-04-25 00:00:00+00:00,Baden-Württemberg,318,367,2569,31262,23.0
2020-04-26 00:00:00+00:00,Baden-Württemberg,133,343,2405,31395,22.0
2020-04-27 00:00:00+00:00,Baden-Württemberg,172,328,2301,31567,21.0
2020-04-28 00:00:00+00:00,Baden-Württemberg,186,299,2096,31753,19.0
2020-04-29 00:00:00+00:00,Baden-Württemberg,276,267,1869,32029,17.0
2020-04-30 00:00:00+00:00,Baden-Württemberg,258,243,1704,32287,15.0
2020-05-01 00:00:00+00:00,Baden-Württemberg,153,213,1496,32440,13.0
2020-05-02 00:00:00+00:00,Baden-Württemberg,111,184,1289,32551,12.0
2020-05-03 00:00:00+00:00,Baden-Württemberg,49,172,1205,32600,11.0
2020-05-04 00:00:00+00:00,Baden-Württemberg,79,158,1112,32679,10.0
2020-05-05 00:00:00+00:00,Baden-Württemberg,127,150,1053,32806,9.0
2020-05-06 00:00:00+00:00,Baden-Württemberg,128,129,905,32934,8.0
2020-05-07 00:00:00+00:00,Baden-Württemberg,177,117,824,33111,7.0
2020-05-08 00:00:00+00:00,Baden-Württemberg,204,125,875,33315,8.0
2020-05-09 00:00:00+00:00,Baden-Württemberg,128,127,892,33443,8.0
2020-05-10 00:00:00+00:00,Baden-Württemberg,55,128,898,33498,8.0
2020-05-11 00:00:00+00:00,Baden-Württemberg,97,130,916,33595,8.0
2020-05-12 00:00:00+00:00,Baden-Württemberg,101,127,890,33696,8.0
2020-05-13 00:00:00+00:00,Baden-Württemberg,127,127,889,33823,8.0
2020-05-14 00:00:00+00:00,Baden-Württemberg,100,116,812,33923,7.0
2020-05-15 00:00:00+00:00,Baden-Württemberg,103,101,711,34026,6.0
2020-05-16 00:00:00+00:00,Baden-Württemberg,52,90,635,34078,6.0
2020-05-17 00:00:00+00:00,Baden-Württemberg,32,87,612,34110,6.0
2020-05-18 00:00:00+00:00,Baden-Württemberg,41,79,556,34151,5.0
2020-05-19 00:00:00+00:00,Baden-Württemberg,103,79,558,34254,5.0
2020-05-20 00:00:00+00:00,Baden-Württemberg,87,74,518,34341,5.0
2020-05-21 00:00:00+00:00,Baden-Württemberg,42,65,460,34383,4.0
2020-05-22 00:00:00+00:00,Baden-Württemberg,63,60,420,34446,4.0
2020-05-23 00:00:00+00:00,Baden-Württemberg,49,59,417,34495,4.0
2020-05-24 00:00:00+00:00,Baden-Württemberg,17,57,402,34512,4.0
2020-05-25 00:00:00+00:00,Baden-Württemberg,35,56,396,34547,4.0
2020-05-26 00:00:00+00:00,Baden-Württemberg,58,50,351,34605,3.0
2020-05-27 00:00:00+00:00,Baden-Württemberg,80,49,344,34685,3.0
2020-05-28 00:00:00+00:00,Baden-Württemberg,64,52,366,34749,3.0
2020-05-29 00:00:00+00:00,Baden-Württemberg,39,48,342,34788,3.0
2020-05-30 00:00:00+00:00,Baden-Württemberg,24,45,317,34812,3.0
2020-05-31 00:00:00+00:00,Baden-Württemberg,11,44,311,34823,3.0
2020-06-01 00:00:00+00:00,Baden-Württemberg,7,40,283,34830,3.0
2020-06-02 00:00:00+00:00,Baden-Württemberg,17,34,242,34847,2.0
2020-06-03 00:00:00+00:00,Baden-Württemberg,31,27,193,34878,2.0
2020-06-04 00:00:00+00:00,Baden-Württemberg,47,25,176,34925,2.0
2020-06-05 00:00:00+00:00,Baden-Württemberg,34,24,171,34959,2.0
2020-06-06 00:00:00+00:00,Baden-Württemberg,31,25,178,34990,2.0
2020-06-07 00:00:00+00:00,Baden-Württemberg,12,25,179,35002,2.0
2020-06-08 00:00:00+00:00,Baden-Württemberg,11,26,183,35013,2.0
2020-06-09 00:00:00+00:00,Baden-Württemberg,31,28,197,35044,2.0
2020-06-10 00:00:00+00:00,Baden-Württemberg,51,31,217,35095,2.0
2020-06-11 00:00:00+00:00,Baden-Württemberg,14,26,184,35109,2.0
2020-06-12 00:00:00+00:00,Baden-Württemberg,32,26,182,35141,2.0
2020-06-13 00:00:00+00:00,Baden-Württemberg,10,23,161,35151,1.0
2020-06-14 00:00:00+00:00,Baden-Württemberg,20,24,169,35171,2.0
2020-06-15 00:00:00+00:00,Baden-Württemberg,17,25,175,35188,2.0
2020-06-16 00:00:00+00:00,Baden-Württemberg,39,26,183,35227,2.0
2020-06-17 00:00:00+00:00,Baden-Württemberg,25,22,157,35252,1.0
2020-06-18 00:00:00+00:00,Baden-Württemberg,25,24,168,35277,2.0
2020-06-19 00:00:00+00:00,Baden-Württemberg,35,24,171,35312,2.0
2020-06-20 00:00:00+00:00,Baden-Württemberg,36,28,197,35348,2.0
2020-06-21 00:00:00+00:00,Baden-Württemberg,11,26,188,35359,2.0
2020-06-22 00:00:00+00:00,Baden-Württemberg,24,27,195,35383,2.0
2020-06-23 00:00:00+00:00,Baden-Württemberg,36,27,192,35419,2.0
2020-06-24 00:00:00+00:00,Baden-Württemberg,44,30,211,35463,2.0
2020-06-25 00:00:00+00:00,Baden-Württemberg,43,32,229,35506,2.0
2020-06-26 00:00:00+00:00,Baden-Württemberg,74,38,268,35580,2.0
2020-06-27 00:00:00+00:00,Baden-Württemberg,35,38,267,35615,2.0
2020-06-28 00:00:00+00:00,Baden-Württemberg,11,38,267,35626,2.0
2020-06-29 00:00:00+00:00,Baden-Württemberg,15,36,258,35641,2.0
2020-06-30 00:00:00+00:00,Baden-Württemberg,48,38,270,35689,2.0
2020-07-01 00:00:00+00:00,Baden-Württemberg,48,39,274,35737,2.0
2020-07-02 00:00:00+00:00,Baden-Württemberg,33,37,264,35770,2.0
2020-07-03 00:00:00+00:00,Baden-Württemberg,40,32,230,35810,2.0
2020-07-04 00:00:00+00:00,Baden-Württemberg,22,31,217,35832,2.0
2020-07-05 00:00:00+00:00,Baden-Württemberg,4,30,210,35836,2.0
2020-07-06 00:00:00+00:00,Baden-Württemberg,40,33,235,35876,2.0
2020-07-07 00:00:00+00:00,Baden-Württemberg,35,31,222,35911,2.0
2020-07-08 00:00:00+00:00,Baden-Württemberg,46,31,220,35957,2.0
2020-07-09 00:00:00+00:00,Baden-Württemberg,52,34,239,36009,2.0
2020-07-10 00:00:00+00:00,Baden-Württemberg,38,33,237,36047,2.0
2020-07-11 00:00:00+00:00,Baden-Württemberg,24,34,239,36071,2.0
2020-07-12 00:00:00+00:00,Baden-Württemberg,16,35,251,36087,2.0
2020-07-13 00:00:00+00:00,Baden-Württemberg,45,36,256,36132,2.0
2020-07-14 00:00:00+00:00,Baden-Württemberg,63,40,284,36195,3.0
2020-07-15 00:00:00+00:00,Baden-Württemberg,46,40,284,36241,3.0
2020-07-16 00:00:00+00:00,Baden-Württemberg,58,41,290,36299,3.0
2020-07-17 00:00:00+00:00,Baden-Württemberg,81,47,333,36380,3.0
2020-07-18 00:00:00+00:00,Baden-Württemberg,58,52,367,36438,3.0
2020-07-19 00:00:00+00:00,Baden-Württemberg,28,54,379,36466,3.0
2020-07-20 00:00:00+00:00,Baden-Württemberg,63,56,397,36529,4.0
2020-07-21 00:00:00+00:00,Baden-Württemberg,53,55,387,36582,3.0
2020-07-22 00:00:00+00:00,Baden-Württemberg,102,63,443,36684,4.0
2020-07-23 00:00:00+00:00,Baden-Württemberg,88,67,473,36772,4.0
2020-07-24 00:00:00+00:00,Baden-Württemberg,109,71,501,36881,5.0
2020-07-25 00:00:00+00:00,Baden-Württemberg,51,70,494,36932,4.0
2020-07-26 00:00:00+00:00,Baden-Württemberg,18,69,484,36950,4.0
2020-07-27 00:00:00+00:00,Baden-Württemberg,79,71,500,37029,5.0
2020-07-28 00:00:00+00:00,Baden-Württemberg,68,73,515,37097,5.0
2020-07-29 00:00:00+00:00,Baden-Württemberg,100,73,513,37197,5.0
2020-07-30 00:00:00+00:00,Baden-Württemberg,95,74,520,37292,5.0
2020-07-31 00:00:00+00:00,Baden-Württemberg,103,73,514,37395,5.0
2020-08-01 00:00:00+00:00,Baden-Württemberg,43,72,506,37438,5.0
2020-08-02 00:00:00+00:00,Baden-Württemberg,11,71,499,37449,4.0
2020-08-03 00:00:00+00:00,Baden-Württemberg,55,67,475,37504,4.0
2020-08-04 00:00:00+00:00,Baden-Württemberg,65,67,472,37569,4.0
2020-08-05 00:00:00+00:00,Baden-Württemberg,90,66,462,37659,4.0
2020-08-06 00:00:00+00:00,Baden-Württemberg,79,63,446,37738,4.0
2020-08-07 00:00:00+00:00,Baden-Württemberg,81,60,424,37819,4.0
2020-08-08 00:00:00+00:00,Baden-Württemberg,58,62,439,37877,4.0
2020-08-09 00:00:00+00:00,Baden-Württemberg,24,64,452,37901,4.0
2020-08-10 00:00:00+00:00,Baden-Württemberg,81,68,478,37982,4.0
2020-08-11 00:00:00+00:00,Baden-Württemberg,120,76,533,38102,5.0
2020-08-12 00:00:00+00:00,Baden-Württemberg,151,84,594,38253,5.0
2020-08-13 00:00:00+00:00,Baden-Württemberg,148,94,663,38401,6.0
2020-08-14 00:00:00+00:00,Baden-Württemberg,152,104,734,38553,7.0
2020-08-15 00:00:00+00:00,Baden-Württemberg,94,110,770,38647,7.0
2020-08-16 00:00:00+00:00,Baden-Württemberg,30,110,776,38677,7.0
2020-08-17 00:00:00+00:00,Baden-Württemberg,220,130,915,38897,8.0
2020-08-18 00:00:00+00:00,Baden-Württemberg,275,152,1070,39172,10.0
2020-08-19 00:00:00+00:00,Baden-Württemberg,294,173,1213,39466,11.0
2020-08-20 00:00:00+00:00,Baden-Württemberg,257,188,1322,39723,12.0
2020-08-21 00:00:00+00:00,Baden-Württemberg,306,210,1476,40029,13.0
2020-08-22 00:00:00+00:00,Baden-Württemberg,184,223,1566,40213,14.0
2020-08-23 00:00:00+00:00,Baden-Württemberg,140,239,1676,40353,15.0
2020-08-24 00:00:00+00:00,Baden-Württemberg,231,241,1687,40584,15.0
2020-08-25 00:00:00+00:00,Baden-Württemberg,305,245,1717,40889,15.0
2020-08-26 00:00:00+00:00,Baden-Württemberg,294,245,1717,41183,15.0
2020-08-27 00:00:00+00:00,Baden-Württemberg,329,255,1789,41512,16.0
2020-08-28 00:00:00+00:00,Baden-Württemberg,288,253,1771,41800,16.0
2020-08-29 00:00:00+00:00,Baden-Württemberg,177,252,1764,41977,16.0
2020-08-30 00:00:00+00:00,Baden-Württemberg,147,253,1771,42124,16.0
2020-08-31 00:00:00+00:00,Baden-Württemberg,175,245,1715,42299,15.0
2020-09-01 00:00:00+00:00,Baden-Württemberg,287,242,1697,42586,15.0
2020-09-02 00:00:00+00:00,Baden-Württemberg,302,243,1705,42888,15.0
2020-09-03 00:00:00+00:00,Baden-Württemberg,283,237,1659,43171,15.0
2020-09-04 00:00:00+00:00,Baden-Württemberg,289,237,1660,43460,15.0
2020-09-05 00:00:00+00:00,Baden-Württemberg,264,249,1747,43724,16.0
2020-09-06 00:00:00+00:00,Baden-Württemberg,100,242,1700,43824,15.0
2020-09-07 00:00:00+00:00,Baden-Württemberg,219,249,1744,44043,16.0
2020-09-08 00:00:00+00:00,Baden-Württemberg,238,242,1695,44281,15.0
2020-09-09 00:00:00+00:00,Baden-Württemberg,282,239,1675,44563,15.0
2020-09-10 00:00:00+00:00,Baden-Württemberg,281,239,1673,44844,15.0
2020-09-11 00:00:00+00:00,Baden-Württemberg,267,235,1651,45111,15.0
2020-09-12 00:00:00+00:00,Baden-Württemberg,224,230,1611,45335,15.0
2020-09-13 00:00:00+00:00,Baden-Württemberg,114,232,1625,45449,15.0
2020-09-14 00:00:00+00:00,Baden-Württemberg,191,228,1597,45640,14.0
2020-09-15 00:00:00+00:00,Baden-Württemberg,372,247,1731,46012,16.0
2020-09-16 00:00:00+00:00,Baden-Württemberg,357,258,1806,46369,16.0
2020-09-17 00:00:00+00:00,Baden-Württemberg,373,271,1898,46742,17.0
2020-09-18 00:00:00+00:00,Baden-Württemberg,303,276,1934,47045,17.0
2020-09-19 00:00:00+00:00,Baden-Württemberg,205,273,1915,47250,17.0
2020-09-20 00:00:00+00:00,Baden-Württemberg,113,273,1914,47363,17.0
2020-09-21 00:00:00+00:00,Baden-Württemberg,187,272,1910,47550,17.0
2020-09-22 00:00:00+00:00,Baden-Württemberg,236,253,1774,47786,16.0
2020-09-23 00:00:00+00:00,Baden-Württemberg,329,249,1746,48115,16.0
2020-09-24 00:00:00+00:00,Baden-Württemberg,305,239,1678,48420,15.0
2020-09-25 00:00:00+00:00,Baden-Württemberg,320,242,1695,48740,15.0
2020-09-26 00:00:00+00:00,Baden-Württemberg,279,252,1769,49019,16.0
2020-09-27 00:00:00+00:00,Baden-Württemberg,141,256,1797,49160,16.0
2020-09-28 00:00:00+00:00,Baden-Württemberg,207,259,1817,49367,16.0
2020-09-29 00:00:00+00:00,Baden-Württemberg,253,262,1834,49620,17.0
2020-09-30 00:00:00+00:00,Baden-Württemberg,328,261,1833,49948,17.0
2020-10-01 00:00:00+00:00,Baden-Württemberg,384,273,1912,50332,17.0
2020-10-02 00:00:00+00:00,Baden-Württemberg,422,287,2014,50754,18.0
2020-10-03 00:00:00+00:00,Baden-Württemberg,275,287,2010,51029,18.0
2020-10-04 00:00:00+00:00,Baden-Württemberg,158,289,2027,51187,18.0
2020-10-05 00:00:00+00:00,Baden-Württemberg,291,301,2111,51478,19.0
2020-10-06 00:00:00+00:00,Baden-Württemberg,612,352,2470,52090,22.0
2020-10-07 00:00:00+00:00,Baden-Württemberg,598,391,2740,52688,25.0
2020-10-08 00:00:00+00:00,Baden-Württemberg,593,421,2949,53281,27.0
2020-10-09 00:00:00+00:00,Baden-Württemberg,720,463,3247,54001,29.0
2020-10-10 00:00:00+00:00,Baden-Württemberg,636,515,3608,54637,33.0
2020-10-11 00:00:00+00:00,Baden-Württemberg,303,536,3753,54940,34.0
2020-10-12 00:00:00+00:00,Baden-Württemberg,552,573,4014,55492,36.0
2020-10-13 00:00:00+00:00,Baden-Württemberg,834,605,4236,56326,38.0
2020-10-14 00:00:00+00:00,Baden-Württemberg,939,653,4577,57265,41.0
2020-10-15 00:00:00+00:00,Baden-Württemberg,1079,723,5063,58344,46.0
2020-10-16 00:00:00+00:00,Baden-Württemberg,1068,773,5411,59412,49.0
2020-10-17 00:00:00+00:00,Baden-Württemberg,794,795,5569,60206,50.0
2020-10-18 00:00:00+00:00,Baden-Württemberg,538,829,5804,60744,52.0
2020-10-19 00:00:00+00:00,Baden-Württemberg,768,860,6020,61512,54.0
2020-10-20 00:00:00+00:00,Baden-Württemberg,1365,935,6551,62877,59.0
2020-10-21 00:00:00+00:00,Baden-Württemberg,1712,1046,7324,64589,66.0
2020-10-22 00:00:00+00:00,Baden-Württemberg,1992,1176,8237,66581,74.0
2020-10-23 00:00:00+00:00,Baden-Württemberg,1950,1302,9119,68531,82.0
2020-10-24 00:00:00+00:00,Baden-Württemberg,1320,1377,9645,69851,87.0
2020-10-25 00:00:00+00:00,Baden-Württemberg,917,1432,10024,70768,90.0
2020-10-26 00:00:00+00:00,Baden-Württemberg,1810,1580,11066,72578,100.0
2020-10-27 00:00:00+00:00,Baden-Württemberg,2124,1689,11825,74702,107.0
2020-10-28 00:00:00+00:00,Baden-Württemberg,2650,1823,12763,77352,115.0
2020-10-29 00:00:00+00:00,Baden-Württemberg,2433,1886,13204,79785,119.0
2020-10-30 00:00:00+00:00,Baden-Württemberg,2710,1994,13964,82495,126.0
2020-10-31 00:00:00+00:00,Baden-Württemberg,1622,2038,14266,84117,129.0
2020-11-01 00:00:00+00:00,Baden-Württemberg,1255,2086,14604,85372,132.0
2020-11-02 00:00:00+00:00,Baden-Württemberg,1898,2098,14692,87270,132.0
2020-11-03 00:00:00+00:00,Baden-Württemberg,2788,2193,15356,90058,138.0
2020-11-04 00:00:00+00:00,Baden-Württemberg,2702,2201,15408,92760,139.0
2020-11-05 00:00:00+00:00,Baden-Württemberg,2984,2279,15959,95744,144.0
2020-11-06 00:00:00+00:00,Baden-Württemberg,2820,2295,16069,98564,145.0
2020-11-07 00:00:00+00:00,Baden-Württemberg,2377,2403,16824,100941,152.0
2020-11-08 00:00:00+00:00,Baden-Württemberg,1160,2389,16729,102101,151.0
2020-11-09 00:00:00+00:00,Baden-Württemberg,1654,2355,16485,103755,149.0
2020-11-10 00:00:00+00:00,Baden-Württemberg,2419,2302,16116,106174,145.0
2020-11-11 00:00:00+00:00,Baden-Württemberg,3028,2348,16442,109202,148.0
2020-11-12 00:00:00+00:00,Baden-Württemberg,3016,2353,16474,112218,148.0
2020-11-13 00:00:00+00:00,Baden-Württemberg,2704,2336,16358,114922,147.0
2020-11-14 00:00:00+00:00,Baden-Württemberg,1989,2281,15970,116911,144.0
2020-11-15 00:00:00+00:00,Baden-Württemberg,1127,2276,15937,118038,144.0
2020-11-16 00:00:00+00:00,Baden-Württemberg,1541,2260,15824,119579,143.0
2020-11-17 00:00:00+00:00,Baden-Württemberg,2647,2293,16052,122226,145.0
2020-11-18 00:00:00+00:00,Baden-Württemberg,3223,2321,16247,125449,146.0
2020-11-19 00:00:00+00:00,Baden-Württemberg,3061,2327,16292,128510,147.0
2020-11-20 00:00:00+00:00,Baden-Württemberg,2813,2343,16401,131323,148.0
2020-11-21 00:00:00+00:00,Baden-Württemberg,2111,2360,16523,133434,149.0
2020-11-22 00:00:00+00:00,Baden-Württemberg,1050,2349,16446,134484,148.0
2020-11-23 00:00:00+00:00,Baden-Württemberg,1248,2307,16153,135732,146.0
2020-11-24 00:00:00+00:00,Baden-Württemberg,2253,2251,15759,137985,142.0
2020-11-25 00:00:00+00:00,Baden-Württemberg,2853,2198,15389,140838,139.0
2020-11-26 00:00:00+00:00,Baden-Württemberg,3065,2199,15393,143903,139.0
2020-11-27 00:00:00+00:00,Baden-Württemberg,2686,2180,15266,146589,138.0
2020-11-28 00:00:00+00:00,Baden-Württemberg,1976,2161,15131,148565,136.0
2020-11-29 00:00:00+00:00,Baden-Württemberg,1162,2177,15243,149727,137.0
2020-11-30 00:00:00+00:00,Baden-Württemberg,1390,2197,15385,151117,139.0
2020-12-01 00:00:00+00:00,Baden-Württemberg,2513,2235,15645,153630,141.0
2020-12-02 00:00:00+00:00,Baden-Württemberg,3289,2297,16081,156919,145.0
2020-12-03 00:00:00+00:00,Baden-Württemberg,3240,2322,16256,160159,146.0
2020-12-04 00:00:00+00:00,Baden-Württemberg,3124,2384,16694,163283,150.0
2020-12-05 00:00:00+00:00,Baden-Württemberg,2445,2451,17163,165728,155.0
2020-12-06 00:00:00+00:00,Baden-Württemberg,1430,2490,17431,167158,157.0
2020-12-07 00:00:00+00:00,Baden-Württemberg,1796,2548,17837,168954,161.0
2020-12-08 00:00:00+00:00,Baden-Württemberg,3178,2643,18502,172132,167.0
2020-12-09 00:00:00+00:00,Baden-Württemberg,4206,2774,19419,176338,175.0
2020-12-10 00:00:00+00:00,Baden-Württemberg,3926,2872,20105,180264,181.0
2020-12-11 00:00:00+00:00,Baden-Württemberg,3673,2950,20654,183937,186.0
2020-12-12 00:00:00+00:00,Baden-Württemberg,2899,3015,21108,186836,190.0
2020-12-13 00:00:00+00:00,Baden-Württemberg,1922,3085,21600,188758,195.0
2020-12-14 00:00:00+00:00,Baden-Württemberg,2249,3150,22053,191007,199.0
2020-12-15 00:00:00+00:00,Baden-Württemberg,3639,3216,22514,194646,203.0
2020-12-16 00:00:00+00:00,Baden-Württemberg,4103,3201,22411,198749,202.0
2020-12-17 00:00:00+00:00,Baden-Württemberg,4493,3282,22978,203242,207.0
2020-12-18 00:00:00+00:00,Baden-Württemberg,4171,3353,23476,207413,211.0
2020-12-19 00:00:00+00:00,Baden-Württemberg,3284,3408,23861,210697,215.0
2020-12-20 00:00:00+00:00,Baden-Württemberg,1954,3413,23893,212651,215.0
2020-12-21 00:00:00+00:00,Baden-Württemberg,2309,3421,23953,214960,216.0
2020-12-22 00:00:00+00:00,Baden-Württemberg,3445,3394,23759,218405,214.0
2020-12-23 00:00:00+00:00,Baden-Württemberg,4506,3451,24162,222911,218.0
2020-12-24 00:00:00+00:00,Baden-Württemberg,3264,3276,22933,226175,207.0
2020-12-25 00:00:00+00:00,Baden-Württemberg,1685,2921,20447,227860,184.0
2020-12-26 00:00:00+00:00,Baden-Württemberg,1402,2652,18565,229262,167.0
2020-12-27 00:00:00+00:00,Baden-Württemberg,960,2510,17571,230222,158.0
2020-12-28 00:00:00+00:00,Baden-Württemberg,1910,2453,17172,232132,155.0
2020-12-29 00:00:00+00:00,Baden-Württemberg,3025,2393,16752,235157,151.0
2020-12-30 00:00:00+00:00,Baden-Württemberg,3834,2297,16080,238991,145.0
2020-12-31 00:00:00+00:00,Baden-Württemberg,2795,2230,15611,241786,141.0
2021-01-01 00:00:00+00:00,Baden-Württemberg,1322,2178,15248,243108,137.0
2021-01-02 00:00:00+00:00,Baden-Württemberg,990,2119,14836,244098,134.0
2021-01-03 00:00:00+00:00,Baden-Württemberg,1075,2135,14951,245173,135.0
2021-01-04 00:00:00+00:00,Baden-Württemberg,1451,2070,14492,246624,131.0
2021-01-05 00:00:00+00:00,Baden-Württemberg,3218,2097,14685,249842,132.0
2021-01-06 00:00:00+00:00,Baden-Württemberg,2572,1917,13423,252414,121.0
2021-01-07 00:00:00+00:00,Baden-Württemberg,2557,1883,13185,254971,119.0
2021-01-08 00:00:00+00:00,Baden-Württemberg,2826,2098,14689,257797,132.0
2021-01-09 00:00:00+00:00,Baden-Württemberg,2165,2266,15864,259962,143.0
2021-01-10 00:00:00+00:00,Baden-Württemberg,1184,2281,15973,261146,144.0
2021-01-11 00:00:00+00:00,Baden-Württemberg,1296,2259,15818,262442,142.0
2021-01-12 00:00:00+00:00,Baden-Württemberg,2558,2165,15158,265000,137.0
2021-01-13 00:00:00+00:00,Baden-Württemberg,2996,2226,15582,267996,140.0
2021-01-14 00:00:00+00:00,Baden-Württemberg,2199,2174,15224,270195,137.0
2021-01-15 00:00:00+00:00,Baden-Württemberg,2028,2060,14426,272223,130.0
2021-01-16 00:00:00+00:00,Baden-Württemberg,1612,1981,13873,273835,125.0
2021-01-17 00:00:00+00:00,Baden-Württemberg,754,1920,13443,274589,121.0
2021-01-18 00:00:00+00:00,Baden-Württemberg,821,1852,12968,275410,117.0
2021-01-19 00:00:00+00:00,Baden-Württemberg,1929,1762,12339,277339,111.0
2021-01-20 00:00:00+00:00,Baden-Württemberg,2154,1642,11497,279493,104.0
2021-01-21 00:00:00+00:00,Baden-Württemberg,1965,1609,11263,281458,101.0
2021-01-22 00:00:00+00:00,Baden-Württemberg,1469,1529,10704,282927,96.0
2021-01-23 00:00:00+00:00,Baden-Württemberg,1323,1487,10415,284250,94.0
2021-01-24 00:00:00+00:00,Baden-Württemberg,524,1455,10185,284774,92.0
2021-01-25 00:00:00+00:00,Baden-Württemberg,550,1416,9914,285324,89.0
2021-01-26 00:00:00+00:00,Baden-Württemberg,1572,1365,9557,286896,86.0
2021-01-27 00:00:00+00:00,Baden-Württemberg,1742,1306,9145,288638,82.0
2021-01-28 00:00:00+00:00,Baden-Württemberg,1577,1251,8757,290215,79.0
2021-01-29 00:00:00+00:00,Baden-Württemberg,1373,1237,8661,291588,78.0
2021-01-30 00:00:00+00:00,Baden-Württemberg,1226,1223,8564,292814,77.0
2021-01-31 00:00:00+00:00,Baden-Württemberg,482,1217,8522,293296,77.0
2021-02-01 00:00:00+00:00,Baden-Württemberg,505,1211,8477,293801,76.0
2021-02-02 00:00:00+00:00,Baden-Württemberg,1234,1162,8139,295035,73.0
2021-02-03 00:00:00+00:00,Baden-Württemberg,1405,1114,7802,296440,70.0
2021-02-04 00:00:00+00:00,Baden-Württemberg,1225,1064,7450,297665,67.0
2021-02-05 00:00:00+00:00,Baden-Württemberg,1039,1016,7116,298704,64.0
2021-02-06 00:00:00+00:00,Baden-Württemberg,1062,993,6952,299766,63.0
2021-02-07 00:00:00+00:00,Baden-Württemberg,390,980,6860,300156,62.0
2021-02-08 00:00:00+00:00,Baden-Württemberg,422,968,6777,300578,61.0
2021-02-09 00:00:00+00:00,Baden-Württemberg,1105,949,6648,301683,60.0
2021-02-10 00:00:00+00:00,Baden-Württemberg,1143,912,6386,302826,58.0
2021-02-11 00:00:00+00:00,Baden-Württemberg,972,876,6133,303798,55.0
2021-02-12 00:00:00+00:00,Baden-Württemberg,940,862,6034,304738,54.0
2021-02-13 00:00:00+00:00,Baden-Württemberg,588,794,5560,305326,50.0
2021-02-14 00:00:00+00:00,Baden-Württemberg,322,784,5492,305648,49.0
2021-02-15 00:00:00+00:00,Baden-Württemberg,317,769,5387,305965,49.0
2021-02-16 00:00:00+00:00,Baden-Württemberg,839,731,5121,306804,46.0
2021-02-17 00:00:00+00:00,Baden-Württemberg,876,693,4854,307680,44.0
2021-02-18 00:00:00+00:00,Baden-Württemberg,977,694,4859,308657,44.0
2021-02-19 00:00:00+00:00,Baden-Württemberg,895,687,4814,309552,43.0
2021-02-20 00:00:00+00:00,Baden-Württemberg,898,732,5124,310450,46.0
2021-02-21 00:00:00+00:00,Baden-Württemberg,273,725,5075,310723,46.0
2021-02-22 00:00:00+00:00,Baden-Württemberg,404,737,5162,311127,47.0
2021-02-23 00:00:00+00:00,Baden-Württemberg,1072,770,5395,312199,49.0
2021-02-24 00:00:00+00:00,Baden-Württemberg,1097,802,5616,313296,51.0
2021-02-25 00:00:00+00:00,Baden-Württemberg,1059,814,5698,314355,51.0
2021-02-26 00:00:00+00:00,Baden-Württemberg,950,821,5753,315305,52.0
2021-02-27 00:00:00+00:00,Baden-Württemberg,946,828,5801,316251,52.0
2021-02-28 00:00:00+00:00,Baden-Württemberg,404,847,5932,316655,53.0
2021-03-01 00:00:00+00:00,Baden-Württemberg,435,851,5963,317090,54.0
2021-03-02 00:00:00+00:00,Baden-Württemberg,1303,884,6194,318393,56.0
2021-03-03 00:00:00+00:00,Baden-Württemberg,1291,912,6388,319684,58.0
2021-03-04 00:00:00+00:00,Baden-Württemberg,1158,926,6487,320842,58.0
2021-03-05 00:00:00+00:00,Baden-Württemberg,1195,961,6732,322037,61.0
2021-03-06 00:00:00+00:00,Baden-Württemberg,1120,986,6906,323157,62.0
2021-03-07 00:00:00+00:00,Baden-Württemberg,357,979,6859,323514,62.0
2021-03-08 00:00:00+00:00,Baden-Württemberg,581,1000,7005,324095,63.0
2021-03-09 00:00:00+00:00,Baden-Württemberg,1465,1023,7167,325560,65.0
2021-03-10 00:00:00+00:00,Baden-Württemberg,1589,1066,7465,327149,67.0
2021-03-11 00:00:00+00:00,Baden-Württemberg,1535,1120,7842,328684,71.0
2021-03-12 00:00:00+00:00,Baden-Württemberg,1592,1177,8239,330276,74.0
2021-03-13 00:00:00+00:00,Baden-Württemberg,1379,1214,8498,331655,77.0
2021-03-14 00:00:00+00:00,Baden-Württemberg,541,1240,8682,332196,78.0
2021-03-15 00:00:00+00:00,Baden-Württemberg,694,1256,8795,332890,79.0
2021-03-16 00:00:00+00:00,Baden-Württemberg,2135,1352,9465,335025,85.0
2021-03-17 00:00:00+00:00,Baden-Württemberg,2206,1440,10082,337231,91.0
2021-03-18 00:00:00+00:00,Baden-Württemberg,1960,1501,10507,339191,95.0
2021-03-19 00:00:00+00:00,Baden-Württemberg,1944,1551,10859,341135,98.0
2021-03-20 00:00:00+00:00,Baden-Württemberg,2103,1654,11583,343238,104.0
2021-03-21 00:00:00+00:00,Baden-Württemberg,674,1673,11716,343912,106.0
2021-03-22 00:00:00+00:00,Baden-Württemberg,860,1697,11882,344772,107.0
2021-03-23 00:00:00+00:00,Baden-Württemberg,2489,1748,12236,347261,110.0
2021-03-24 00:00:00+00:00,Baden-Württemberg,2847,1839,12877,350108,116.0
2021-03-25 00:00:00+00:00,Baden-Württemberg,2601,1931,13518,352709,122.0
2021-03-26 00:00:00+00:00,Baden-Württemberg,2563,2019,14137,355272,127.0
2021-03-27 00:00:00+00:00,Baden-Württemberg,2164,2028,14198,357436,128.0
2021-03-28 00:00:00+00:00,Baden-Württemberg,1085,2087,14609,358521,132.0
2021-03-29 00:00:00+00:00,Baden-Württemberg,1204,2136,14953,359725,135.0
2021-03-30 00:00:00+00:00,Baden-Württemberg,2610,2153,15074,362335,136.0
2021-03-31 00:00:00+00:00,Baden-Württemberg,3048,2182,15275,365383,138.0
2021-04-01 00:00:00+00:00,Baden-Württemberg,2748,2203,15422,368131,139.0
2021-04-02 00:00:00+00:00,Baden-Württemberg,2093,2136,14952,370224,135.0
2021-04-03 00:00:00+00:00,Baden-Württemberg,1125,1987,13913,371349,125.0
2021-04-04 00:00:00+00:00,Baden-Württemberg,939,1966,13767,372288,124.0
2021-04-05 00:00:00+00:00,Baden-Württemberg,668,1890,13231,372956,119.0
2021-04-06 00:00:00+00:00,Baden-Württemberg,1323,1706,11944,374279,108.0
2021-04-07 00:00:00+00:00,Baden-Württemberg,3375,1753,12271,377654,111.0
2021-04-08 00:00:00+00:00,Baden-Württemberg,3490,1859,13013,381144,117.0
2021-04-09 00:00:00+00:00,Baden-Württemberg,3148,2009,14068,384292,127.0
2021-04-10 00:00:00+00:00,Baden-Württemberg,2740,2240,15683,387032,141.0
2021-04-11 00:00:00+00:00,Baden-Württemberg,1068,2258,15812,388100,142.0
2021-04-12 00:00:00+00:00,Baden-Württemberg,1536,2382,16680,389636,150.0
2021-04-13 00:00:00+00:00,Baden-Württemberg,3623,2711,18980,393259,171.0
2021-04-14 00:00:00+00:00,Baden-Württemberg,3624,2747,19229,396883,173.0
2021-04-15 00:00:00+00:00,Baden-Württemberg,3633,2767,19372,400516,175.0
2021-04-16 00:00:00+00:00,Baden-Württemberg,3224,2778,19448,403740,175.0
2021-04-17 00:00:00+00:00,Baden-Württemberg,2677,2769,19385,406417,175.0
2021-04-18 00:00:00+00:00,Baden-Württemberg,1130,2778,19447,407547,175.0
2021-04-19 00:00:00+00:00,Baden-Württemberg,1651,2794,19562,409198,176.0
2021-04-20 00:00:00+00:00,Baden-Württemberg,4466,2915,20405,413664,184.0
2021-04-21 00:00:00+00:00,Baden-Württemberg,4421,3028,21202,418085,191.0
2021-04-22 00:00:00+00:00,Baden-Württemberg,3859,3061,21428,421944,193.0
2021-04-23 00:00:00+00:00,Baden-Württemberg,3568,3110,21772,425512,196.0
2021-04-24 00:00:00+00:00,Baden-Württemberg,2943,3148,22038,428455,199.0
2021-04-25 00:00:00+00:00,Baden-Württemberg,1277,3169,22185,429732,200.0
2021-04-26 00:00:00+00:00,Baden-Württemberg,2094,3232,22628,431826,204.0
2021-04-27 00:00:00+00:00,Baden-Württemberg,4196,3194,22358,436022,201.0
2021-04-28 00:00:00+00:00,Baden-Württemberg,4145,3154,22082,440167,199.0
2021-04-29 00:00:00+00:00,Baden-Württemberg,3495,3102,21718,443662,196.0
2021-04-30 00:00:00+00:00,Baden-Württemberg,3265,3059,21415,446927,193.0
2021-05-01 00:00:00+00:00,Baden-Württemberg,2481,2993,20953,449408,189.0
2021-05-02 00:00:00+00:00,Baden-Württemberg,1001,2953,20677,450409,186.0
2021-05-03 00:00:00+00:00,Baden-Württemberg,1417,2857,20000,451826,180.0
2021-05-04 00:00:00+00:00,Baden-Württemberg,3532,2762,19336,455358,174.0
2021-05-05 00:00:00+00:00,Baden-Württemberg,3298,2641,18489,458656,167.0
2021-05-06 00:00:00+00:00,Baden-Württemberg,2976,2567,17970,461632,162.0
2021-05-07 00:00:00+00:00,Baden-Württemberg,2485,2455,17190,464117,155.0
2021-05-08 00:00:00+00:00,Baden-Württemberg,1922,2375,16631,466039,150.0
2021-05-09 00:00:00+00:00,Baden-Württemberg,765,2342,16395,466804,148.0
2021-05-10 00:00:00+00:00,Baden-Württemberg,1281,2322,16259,468085,146.0
2021-05-11 00:00:00+00:00,Baden-Württemberg,2713,2205,15440,470798,139.0
2021-05-12 00:00:00+00:00,Baden-Württemberg,2787,2132,14929,473585,134.0
2021-05-13 00:00:00+00:00,Baden-Württemberg,1656,1944,13609,475241,123.0
2021-05-14 00:00:00+00:00,Baden-Württemberg,1187,1758,12311,476428,111.0
2021-05-15 00:00:00+00:00,Baden-Württemberg,1281,1667,11670,477709,105.0
2021-05-16 00:00:00+00:00,Baden-Württemberg,538,1634,11443,478247,103.0
2021-05-17 00:00:00+00:00,Baden-Württemberg,891,1579,11053,479138,100.0
2021-05-18 00:00:00+00:00,Baden-Württemberg,2049,1484,10389,481187,94.0
2021-05-19 00:00:00+00:00,Baden-Württemberg,1900,1357,9502,483087,86.0
2021-05-20 00:00:00+00:00,Baden-Württemberg,1389,1319,9235,484476,83.0
2021-05-21 00:00:00+00:00,Baden-Württemberg,1281,1332,9329,485757,84.0
2021-05-22 00:00:00+00:00,Baden-Württemberg,1051,1299,9099,486808,82.0
2021-05-23 00:00:00+00:00,Baden-Württemberg,390,1278,8951,487198,81.0
2021-05-24 00:00:00+00:00,Baden-Württemberg,274,1190,8334,487472,75.0
2021-05-25 00:00:00+00:00,Baden-Württemberg,536,974,6821,488008,61.0
2021-05-26 00:00:00+00:00,Baden-Württemberg,1167,869,6088,489175,55.0
2021-05-27 00:00:00+00:00,Baden-Württemberg,1120,831,5819,490295,52.0
2021-05-28 00:00:00+00:00,Baden-Württemberg,886,774,5424,491181,49.0
2021-05-29 00:00:00+00:00,Baden-Württemberg,639,716,5012,491820,45.0
2021-05-30 00:00:00+00:00,Baden-Württemberg,261,697,4883,492081,44.0
2021-05-31 00:00:00+00:00,Baden-Württemberg,353,708,4962,492434,45.0
2021-06-01 00:00:00+00:00,Baden-Württemberg,793,745,5219,493227,47.0
2021-06-02 00:00:00+00:00,Baden-Württemberg,742,684,4794,493969,43.0
2021-06-03 00:00:00+00:00,Baden-Württemberg,495,595,4169,494464,38.0
2021-06-04 00:00:00+00:00,Baden-Württemberg,304,512,3587,494768,32.0
2021-06-05 00:00:00+00:00,Baden-Württemberg,412,480,3360,495180,30.0
2021-06-06 00:00:00+00:00,Baden-Württemberg,275,482,3374,495455,30.0
2021-06-07 00:00:00+00:00,Baden-Württemberg,303,474,3324,495758,30.0
2021-06-08 00:00:00+00:00,Baden-Württemberg,701,461,3232,496459,29.0
2021-06-09 00:00:00+00:00,Baden-Württemberg,544,433,3034,497003,27.0
2021-06-10 00:00:00+00:00,Baden-Württemberg,380,417,2919,497383,26.0
2021-06-11 00:00:00+00:00,Baden-Württemberg,370,426,2985,497753,27.0
2021-06-12 00:00:00+00:00,Baden-Württemberg,302,410,2875,498055,26.0
2021-06-13 00:00:00+00:00,Baden-Württemberg,84,383,2684,498139,24.0
2021-06-14 00:00:00+00:00,Baden-Württemberg,147,361,2528,498286,23.0
2021-06-15 00:00:00+00:00,Baden-Württemberg,331,308,2158,498617,19.0
2021-06-16 00:00:00+00:00,Baden-Württemberg,300,273,1914,498917,17.0
2021-06-17 00:00:00+00:00,Baden-Württemberg,246,254,1780,499163,16.0
2021-06-18 00:00:00+00:00,Baden-Württemberg,189,228,1599,499352,14.0
2021-06-19 00:00:00+00:00,Baden-Württemberg,161,208,1458,499513,13.0
2021-06-20 00:00:00+00:00,Baden-Württemberg,40,202,1414,499553,13.0
2021-06-21 00:00:00+00:00,Baden-Württemberg,100,195,1367,499653,12.0
2021-06-22 00:00:00+00:00,Baden-Württemberg,171,172,1207,499824,11.0
2021-06-23 00:00:00+00:00,Baden-Württemberg,169,153,1076,499993,10.0
2021-06-24 00:00:00+00:00,Baden-Württemberg,145,139,975,500138,9.0
2021-06-25 00:00:00+00:00,Baden-Württemberg,159,135,945,500297,9.0
2021-06-26 00:00:00+00:00,Baden-Württemberg,63,121,847,500360,8.0
2021-06-27 00:00:00+00:00,Baden-Württemberg,30,119,837,500390,8.0
2021-06-28 00:00:00+00:00,Baden-Württemberg,70,115,807,500460,7.0
2021-06-29 00:00:00+00:00,Baden-Württemberg,136,110,772,500596,7.0
2021-06-30 00:00:00+00:00,Baden-Württemberg,125,104,728,500721,7.0
2021-07-01 00:00:00+00:00,Baden-Württemberg,91,96,674,500812,6.0
2021-07-02 00:00:00+00:00,Baden-Württemberg,84,85,599,500896,5.0
2021-07-03 00:00:00+00:00,Baden-Württemberg,78,87,614,500974,6.0
2021-07-04 00:00:00+00:00,Baden-Württemberg,19,86,603,500993,5.0
2021-07-05 00:00:00+00:00,Baden-Württemberg,51,83,584,501044,5.0
2021-07-06 00:00:00+00:00,Baden-Württemberg,111,79,559,501155,5.0
2020-01-23 00:00:00+00:00,Saarland,1,0,0,1,0.0
2020-01-31 00:00:00+00:00,Saarland,1,0,0,2,0.0
2020-02-27 00:00:00+00:00,Saarland,1,0,0,3,0.0
2020-02-28 00:00:00+00:00,Saarland,1,0,0,4,0.0
2020-03-08 00:00:00+00:00,Saarland,1,0,0,5,0.0
2020-03-09 00:00:00+00:00,Saarland,5,0,0,10,0.0
2020-03-10 00:00:00+00:00,Saarland,2,1,12,12,1.0
2020-03-11 00:00:00+00:00,Saarland,10,3,21,22,2.0
2020-03-12 00:00:00+00:00,Saarland,13,4,33,35,3.0
2020-03-13 00:00:00+00:00,Saarland,17,7,49,52,5.0
2020-03-14 00:00:00+00:00,Saarland,12,8,60,64,6.0
2020-03-15 00:00:00+00:00,Saarland,17,10,76,81,8.0
2020-03-16 00:00:00+00:00,Saarland,24,13,95,105,10.0
2020-03-17 00:00:00+00:00,Saarland,23,16,116,128,12.0
2020-03-18 00:00:00+00:00,Saarland,42,21,148,170,15.0
2020-03-19 00:00:00+00:00,Saarland,44,25,179,214,18.0
2020-03-20 00:00:00+00:00,Saarland,37,28,199,251,20.0
2020-03-21 00:00:00+00:00,Saarland,38,32,225,289,23.0
2020-03-22 00:00:00+00:00,Saarland,46,36,254,335,26.0
2020-03-23 00:00:00+00:00,Saarland,59,41,289,394,29.0
2020-03-24 00:00:00+00:00,Saarland,33,42,299,427,30.0
2020-03-25 00:00:00+00:00,Saarland,49,43,306,476,31.0
2020-03-26 00:00:00+00:00,Saarland,69,47,331,545,34.0
2020-03-27 00:00:00+00:00,Saarland,63,51,357,608,36.0
2020-03-28 00:00:00+00:00,Saarland,65,54,384,673,39.0
2020-03-29 00:00:00+00:00,Saarland,77,59,415,750,42.0
2020-03-30 00:00:00+00:00,Saarland,66,60,422,816,43.0
2020-03-31 00:00:00+00:00,Saarland,130,74,519,946,53.0
2020-04-01 00:00:00+00:00,Saarland,109,82,579,1055,59.0
2020-04-02 00:00:00+00:00,Saarland,170,97,680,1225,69.0
2020-04-03 00:00:00+00:00,Saarland,70,98,687,1295,70.0
2020-04-04 00:00:00+00:00,Saarland,137,108,759,1432,77.0
2020-04-05 00:00:00+00:00,Saarland,86,109,768,1518,78.0
2020-04-06 00:00:00+00:00,Saarland,75,111,777,1593,79.0
2020-04-07 00:00:00+00:00,Saarland,75,103,722,1668,73.0
2020-04-08 00:00:00+00:00,Saarland,153,109,766,1821,78.0
2020-04-09 00:00:00+00:00,Saarland,133,104,729,1954,74.0
2020-04-10 00:00:00+00:00,Saarland,91,107,750,2045,76.0
2020-04-11 00:00:00+00:00,Saarland,20,90,633,2065,64.0
2020-04-12 00:00:00+00:00,Saarland,22,81,569,2087,58.0
2020-04-13 00:00:00+00:00,Saarland,27,74,521,2114,53.0
2020-04-14 00:00:00+00:00,Saarland,27,67,473,2141,48.0
2020-04-15 00:00:00+00:00,Saarland,48,52,368,2189,37.0
2020-04-16 00:00:00+00:00,Saarland,48,40,283,2237,29.0
2020-04-17 00:00:00+00:00,Saarland,31,31,223,2268,23.0
2020-04-18 00:00:00+00:00,Saarland,27,32,230,2295,23.0
2020-04-19 00:00:00+00:00,Saarland,2,30,210,2297,21.0
2020-04-20 00:00:00+00:00,Saarland,16,28,199,2313,20.0
2020-04-21 00:00:00+00:00,Saarland,36,29,208,2349,21.0
2020-04-22 00:00:00+00:00,Saarland,45,29,205,2394,21.0
2020-04-23 00:00:00+00:00,Saarland,20,25,177,2414,18.0
2020-04-24 00:00:00+00:00,Saarland,22,24,168,2436,17.0
2020-04-25 00:00:00+00:00,Saarland,14,22,155,2450,16.0
2020-04-26 00:00:00+00:00,Saarland,17,24,170,2467,17.0
2020-04-27 00:00:00+00:00,Saarland,5,22,159,2472,16.0
2020-04-28 00:00:00+00:00,Saarland,7,18,130,2479,13.0
2020-04-29 00:00:00+00:00,Saarland,27,16,112,2506,11.0
2020-04-30 00:00:00+00:00,Saarland,23,16,115,2529,12.0
2020-05-01 00:00:00+00:00,Saarland,12,15,105,2541,11.0
2020-05-02 00:00:00+00:00,Saarland,6,13,97,2547,10.0
2020-05-03 00:00:00+00:00,Saarland,4,12,84,2551,9.0
2020-05-04 00:00:00+00:00,Saarland,5,12,84,2556,9.0
2020-05-05 00:00:00+00:00,Saarland,6,11,83,2562,8.0
2020-05-06 00:00:00+00:00,Saarland,9,9,65,2571,7.0
2020-05-07 00:00:00+00:00,Saarland,11,7,53,2582,5.0
2020-05-08 00:00:00+00:00,Saarland,5,6,46,2587,5.0
2020-05-09 00:00:00+00:00,Saarland,4,6,44,2591,4.0
2020-05-11 00:00:00+00:00,Saarland,2,6,42,2593,4.0
2020-05-12 00:00:00+00:00,Saarland,7,6,44,2600,4.0
2020-05-13 00:00:00+00:00,Saarland,8,6,46,2608,5.0
2020-05-14 00:00:00+00:00,Saarland,9,6,46,2617,5.0
2020-05-15 00:00:00+00:00,Saarland,4,5,39,2621,4.0
2020-05-16 00:00:00+00:00,Saarland,2,5,36,2623,4.0
2020-05-18 00:00:00+00:00,Saarland,3,5,35,2626,4.0
2020-05-19 00:00:00+00:00,Saarland,4,5,37,2630,4.0
2020-05-20 00:00:00+00:00,Saarland,2,4,32,2632,3.0
2020-05-21 00:00:00+00:00,Saarland,3,3,27,2635,3.0
2020-05-22 00:00:00+00:00,Saarland,3,3,21,2638,2.0
2020-05-23 00:00:00+00:00,Saarland,4,3,21,2642,2.0
2020-05-24 00:00:00+00:00,Saarland,1,2,20,2643,2.0
2020-05-25 00:00:00+00:00,Saarland,3,2,20,2646,2.0
2020-05-26 00:00:00+00:00,Saarland,4,2,20,2650,2.0
2020-05-27 00:00:00+00:00,Saarland,4,3,22,2654,2.0
2020-05-28 00:00:00+00:00,Saarland,4,3,23,2658,2.0
2020-05-29 00:00:00+00:00,Saarland,5,3,25,2663,3.0
2020-05-30 00:00:00+00:00,Saarland,1,3,22,2664,2.0
2020-05-31 00:00:00+00:00,Saarland,1,3,22,2665,2.0
2020-06-01 00:00:00+00:00,Saarland,7,3,26,2672,3.0
2020-06-02 00:00:00+00:00,Saarland,2,3,24,2674,2.0
2020-06-03 00:00:00+00:00,Saarland,3,3,23,2677,2.0
2020-06-04 00:00:00+00:00,Saarland,1,2,20,2678,2.0
2020-06-05 00:00:00+00:00,Saarland,4,2,19,2682,2.0
2020-06-06 00:00:00+00:00,Saarland,5,3,23,2687,2.0
2020-06-07 00:00:00+00:00,Saarland,1,3,23,2688,2.0
2020-06-08 00:00:00+00:00,Saarland,9,3,25,2697,3.0
2020-06-09 00:00:00+00:00,Saarland,7,4,30,2704,3.0
2020-06-10 00:00:00+00:00,Saarland,5,4,32,2709,3.0
2020-06-12 00:00:00+00:00,Saarland,1,4,32,2710,3.0
2020-06-13 00:00:00+00:00,Saarland,1,4,29,2711,3.0
2020-06-16 00:00:00+00:00,Saarland,1,3,25,2712,3.0
2020-06-17 00:00:00+00:00,Saarland,2,3,26,2714,3.0
2020-06-18 00:00:00+00:00,Saarland,2,2,19,2716,2.0
2020-06-19 00:00:00+00:00,Saarland,1,1,13,2717,1.0
2020-06-20 00:00:00+00:00,Saarland,1,1,9,2718,1.0
2020-06-22 00:00:00+00:00,Saarland,1,1,9,2719,1.0
2020-06-24 00:00:00+00:00,Saarland,1,1,9,2720,1.0
2020-06-25 00:00:00+00:00,Saarland,1,1,9,2721,1.0
2020-06-26 00:00:00+00:00,Saarland,2,1,9,2723,1.0
2020-06-27 00:00:00+00:00,Saarland,1,1,8,2724,1.0
2020-06-28 00:00:00+00:00,Saarland,1,1,8,2725,1.0
2020-07-01 00:00:00+00:00,Saarland,1,1,8,2726,1.0
2020-07-02 00:00:00+00:00,Saarland,1,1,8,2727,1.0
2020-07-04 00:00:00+00:00,Saarland,1,1,8,2728,1.0
2020-07-07 00:00:00+00:00,Saarland,2,1,9,2730,1.0
2020-07-08 00:00:00+00:00,Saarland,1,1,8,2731,1.0
2020-07-09 00:00:00+00:00,Saarland,3,1,10,2734,1.0
2020-07-10 00:00:00+00:00,Saarland,4,1,13,2738,1.0
2020-07-11 00:00:00+00:00,Saarland,2,2,14,2740,1.0
2020-07-12 00:00:00+00:00,Saarland,1,2,14,2741,1.0
2020-07-13 00:00:00+00:00,Saarland,2,2,15,2743,2.0
2020-07-14 00:00:00+00:00,Saarland,2,2,15,2745,2.0
2020-07-15 00:00:00+00:00,Saarland,2,2,16,2747,2.0
2020-07-16 00:00:00+00:00,Saarland,4,2,17,2751,2.0
2020-07-17 00:00:00+00:00,Saarland,4,2,17,2755,2.0
2020-07-18 00:00:00+00:00,Saarland,2,2,17,2757,2.0
2020-07-20 00:00:00+00:00,Saarland,1,2,17,2758,2.0
2020-07-21 00:00:00+00:00,Saarland,5,2,20,2763,2.0
2020-07-22 00:00:00+00:00,Saarland,5,3,23,2768,2.0
2020-07-23 00:00:00+00:00,Saarland,2,3,23,2770,2.0
2020-07-24 00:00:00+00:00,Saarland,9,4,28,2779,3.0
2020-07-25 00:00:00+00:00,Saarland,2,3,26,2781,3.0
2020-07-27 00:00:00+00:00,Saarland,2,3,26,2783,3.0
2020-07-28 00:00:00+00:00,Saarland,7,4,32,2790,3.0
2020-07-29 00:00:00+00:00,Saarland,6,4,33,2796,3.0
2020-07-30 00:00:00+00:00,Saarland,8,5,36,2804,4.0
2020-07-31 00:00:00+00:00,Saarland,3,5,37,2807,4.0
2020-08-01 00:00:00+00:00,Saarland,5,4,33,2812,3.0
2020-08-02 00:00:00+00:00,Saarland,2,4,33,2814,3.0
2020-08-04 00:00:00+00:00,Saarland,5,5,36,2819,4.0
2020-08-05 00:00:00+00:00,Saarland,12,5,41,2831,4.0
2020-08-06 00:00:00+00:00,Saarland,8,6,43,2839,4.0
2020-08-07 00:00:00+00:00,Saarland,7,6,42,2846,4.0
2020-08-08 00:00:00+00:00,Saarland,5,6,44,2851,4.0
2020-08-09 00:00:00+00:00,Saarland,1,5,40,2852,4.0
2020-08-10 00:00:00+00:00,Saarland,14,7,52,2866,5.0
2020-08-11 00:00:00+00:00,Saarland,9,8,56,2875,6.0
2020-08-12 00:00:00+00:00,Saarland,8,7,52,2883,5.0
2020-08-13 00:00:00+00:00,Saarland,15,8,59,2898,6.0
2020-08-14 00:00:00+00:00,Saarland,18,10,70,2916,7.0
2020-08-15 00:00:00+00:00,Saarland,7,10,72,2923,7.0
2020-08-16 00:00:00+00:00,Saarland,3,10,74,2926,7.0
2020-08-17 00:00:00+00:00,Saarland,7,9,67,2933,7.0
2020-08-18 00:00:00+00:00,Saarland,9,9,67,2942,7.0
2020-08-19 00:00:00+00:00,Saarland,19,11,78,2961,8.0
2020-08-20 00:00:00+00:00,Saarland,18,11,81,2979,8.0
2020-08-21 00:00:00+00:00,Saarland,14,11,77,2993,8.0
2020-08-22 00:00:00+00:00,Saarland,4,10,74,2997,7.0
2020-08-23 00:00:00+00:00,Saarland,2,10,73,2999,7.0
2020-08-24 00:00:00+00:00,Saarland,4,10,70,3003,7.0
2020-08-25 00:00:00+00:00,Saarland,9,10,70,3012,7.0
2020-08-26 00:00:00+00:00,Saarland,10,8,61,3022,6.0
2020-08-27 00:00:00+00:00,Saarland,14,8,57,3036,6.0
2020-08-28 00:00:00+00:00,Saarland,18,8,61,3054,6.0
2020-08-29 00:00:00+00:00,Saarland,17,10,74,3071,7.0
2020-08-31 00:00:00+00:00,Saarland,3,10,75,3074,8.0
2020-09-01 00:00:00+00:00,Saarland,2,10,73,3076,7.0
2020-09-02 00:00:00+00:00,Saarland,12,10,76,3088,8.0
2020-09-03 00:00:00+00:00,Saarland,6,10,72,3094,7.0
2020-09-04 00:00:00+00:00,Saarland,15,10,73,3109,7.0
2020-09-05 00:00:00+00:00,Saarland,6,8,61,3115,6.0
2020-09-07 00:00:00+00:00,Saarland,1,6,45,3116,5.0
2020-09-08 00:00:00+00:00,Saarland,7,7,49,3123,5.0
2020-09-09 00:00:00+00:00,Saarland,11,8,58,3134,6.0
2020-09-10 00:00:00+00:00,Saarland,7,7,53,3141,5.0
2020-09-11 00:00:00+00:00,Saarland,10,8,57,3151,6.0
2020-09-12 00:00:00+00:00,Saarland,6,6,48,3157,5.0
2020-09-13 00:00:00+00:00,Saarland,1,6,43,3158,4.0
2020-09-14 00:00:00+00:00,Saarland,4,6,46,3162,5.0
2020-09-15 00:00:00+00:00,Saarland,7,6,46,3169,5.0
2020-09-16 00:00:00+00:00,Saarland,22,8,57,3191,6.0
2020-09-17 00:00:00+00:00,Saarland,14,9,64,3205,6.0
2020-09-18 00:00:00+00:00,Saarland,8,8,62,3213,6.0
2020-09-19 00:00:00+00:00,Saarland,7,9,63,3220,6.0
2020-09-20 00:00:00+00:00,Saarland,1,9,63,3221,6.0
2020-09-21 00:00:00+00:00,Saarland,9,9,68,3230,7.0
2020-09-22 00:00:00+00:00,Saarland,15,10,76,3245,8.0
2020-09-23 00:00:00+00:00,Saarland,8,8,62,3253,6.0
2020-09-24 00:00:00+00:00,Saarland,6,7,54,3259,5.0
2020-09-25 00:00:00+00:00,Saarland,15,8,61,3274,6.0
2020-09-26 00:00:00+00:00,Saarland,8,8,62,3282,6.0
2020-09-27 00:00:00+00:00,Saarland,2,9,63,3284,6.0
2020-09-28 00:00:00+00:00,Saarland,4,8,58,3288,6.0
2020-09-29 00:00:00+00:00,Saarland,23,9,66,3311,7.0
2020-09-30 00:00:00+00:00,Saarland,31,12,89,3342,9.0
2020-10-01 00:00:00+00:00,Saarland,28,15,111,3370,11.0
2020-10-02 00:00:00+00:00,Saarland,26,17,122,3396,12.0
2020-10-03 00:00:00+00:00,Saarland,27,20,141,3423,14.0
2020-10-04 00:00:00+00:00,Saarland,6,20,145,3429,15.0
2020-10-05 00:00:00+00:00,Saarland,14,22,155,3443,16.0
2020-10-06 00:00:00+00:00,Saarland,41,24,173,3484,18.0
2020-10-07 00:00:00+00:00,Saarland,33,25,175,3517,18.0
2020-10-08 00:00:00+00:00,Saarland,37,26,184,3554,19.0
2020-10-09 00:00:00+00:00,Saarland,64,31,222,3618,22.0
2020-10-10 00:00:00+00:00,Saarland,69,37,264,3687,27.0
2020-10-11 00:00:00+00:00,Saarland,42,42,300,3729,30.0
2020-10-12 00:00:00+00:00,Saarland,29,45,315,3758,32.0
2020-10-13 00:00:00+00:00,Saarland,116,55,390,3874,40.0
2020-10-14 00:00:00+00:00,Saarland,111,66,468,3985,47.0
2020-10-15 00:00:00+00:00,Saarland,164,85,595,4149,60.0
2020-10-16 00:00:00+00:00,Saarland,139,95,670,4288,68.0
2020-10-17 00:00:00+00:00,Saarland,88,98,689,4376,70.0
2020-10-18 00:00:00+00:00,Saarland,26,96,673,4402,68.0
2020-10-19 00:00:00+00:00,Saarland,48,98,692,4450,70.0
2020-10-20 00:00:00+00:00,Saarland,153,104,729,4603,74.0
2020-10-21 00:00:00+00:00,Saarland,200,116,818,4803,83.0
2020-10-22 00:00:00+00:00,Saarland,222,125,876,5025,89.0
2020-10-23 00:00:00+00:00,Saarland,218,136,955,5243,97.0
2020-10-24 00:00:00+00:00,Saarland,119,140,986,5362,100.0
2020-10-25 00:00:00+00:00,Saarland,115,153,1075,5477,109.0
2020-10-26 00:00:00+00:00,Saarland,166,170,1193,5643,121.0
2020-10-27 00:00:00+00:00,Saarland,273,187,1313,5916,133.0
2020-10-28 00:00:00+00:00,Saarland,222,190,1335,6138,135.0
2020-10-29 00:00:00+00:00,Saarland,301,202,1414,6439,143.0
2020-10-30 00:00:00+00:00,Saarland,264,208,1460,6703,148.0
2020-10-31 00:00:00+00:00,Saarland,256,228,1597,6959,162.0
2020-11-01 00:00:00+00:00,Saarland,174,236,1656,7133,168.0
2020-11-02 00:00:00+00:00,Saarland,177,238,1667,7310,169.0
2020-11-03 00:00:00+00:00,Saarland,259,236,1653,7569,167.0
2020-11-04 00:00:00+00:00,Saarland,231,237,1662,7800,168.0
2020-11-05 00:00:00+00:00,Saarland,331,241,1692,8131,171.0
2020-11-06 00:00:00+00:00,Saarland,210,234,1638,8341,166.0
2020-11-07 00:00:00+00:00,Saarland,255,233,1637,8596,166.0
2020-11-08 00:00:00+00:00,Saarland,164,232,1627,8760,165.0
2020-11-09 00:00:00+00:00,Saarland,196,235,1646,8956,167.0
2020-11-10 00:00:00+00:00,Saarland,282,238,1669,9238,169.0
2020-11-11 00:00:00+00:00,Saarland,313,250,1751,9551,177.0
2020-11-12 00:00:00+00:00,Saarland,282,243,1702,9833,172.0
2020-11-13 00:00:00+00:00,Saarland,204,242,1696,10037,172.0
2020-11-14 00:00:00+00:00,Saarland,193,233,1634,10230,166.0
2020-11-15 00:00:00+00:00,Saarland,109,225,1579,10339,160.0
2020-11-16 00:00:00+00:00,Saarland,105,212,1488,10444,151.0
2020-11-17 00:00:00+00:00,Saarland,216,203,1422,10660,144.0
2020-11-18 00:00:00+00:00,Saarland,215,189,1324,10875,134.0
2020-11-19 00:00:00+00:00,Saarland,308,192,1350,11183,137.0
2020-11-20 00:00:00+00:00,Saarland,168,187,1314,11351,133.0
2020-11-21 00:00:00+00:00,Saarland,109,175,1230,11460,125.0
2020-11-22 00:00:00+00:00,Saarland,134,179,1255,11594,127.0
2020-11-23 00:00:00+00:00,Saarland,49,171,1199,11643,121.0
2020-11-24 00:00:00+00:00,Saarland,194,168,1177,11837,119.0
2020-11-25 00:00:00+00:00,Saarland,275,176,1237,12112,125.0
2020-11-26 00:00:00+00:00,Saarland,179,158,1108,12291,112.0
2020-11-27 00:00:00+00:00,Saarland,138,154,1078,12429,109.0
2020-11-28 00:00:00+00:00,Saarland,221,170,1190,12650,121.0
2020-11-29 00:00:00+00:00,Saarland,173,175,1229,12823,125.0
2020-11-30 00:00:00+00:00,Saarland,46,175,1226,12869,124.0
2020-12-01 00:00:00+00:00,Saarland,227,179,1259,13096,128.0
2020-12-02 00:00:00+00:00,Saarland,204,169,1188,13300,120.0
2020-12-03 00:00:00+00:00,Saarland,255,180,1264,13555,128.0
2020-12-04 00:00:00+00:00,Saarland,244,195,1370,13799,139.0
2020-12-05 00:00:00+00:00,Saarland,224,196,1373,14023,139.0
2020-12-06 00:00:00+00:00,Saarland,166,195,1366,14189,138.0
2020-12-07 00:00:00+00:00,Saarland,83,200,1403,14272,142.0
2020-12-08 00:00:00+00:00,Saarland,266,206,1442,14538,146.0
2020-12-09 00:00:00+00:00,Saarland,356,227,1594,14894,162.0
2020-12-10 00:00:00+00:00,Saarland,519,265,1858,15413,188.0
2020-12-11 00:00:00+00:00,Saarland,248,266,1862,15661,189.0
2020-12-12 00:00:00+00:00,Saarland,294,276,1932,15955,196.0
2020-12-13 00:00:00+00:00,Saarland,160,275,1926,16115,195.0
2020-12-14 00:00:00+00:00,Saarland,78,274,1921,16193,195.0
2020-12-15 00:00:00+00:00,Saarland,408,294,2063,16601,209.0
2020-12-16 00:00:00+00:00,Saarland,299,286,2006,16900,203.0
2020-12-17 00:00:00+00:00,Saarland,376,266,1863,17276,189.0
2020-12-18 00:00:00+00:00,Saarland,296,273,1911,17572,194.0
2020-12-19 00:00:00+00:00,Saarland,197,259,1814,17769,184.0
2020-12-20 00:00:00+00:00,Saarland,92,249,1746,17861,177.0
2020-12-21 00:00:00+00:00,Saarland,220,269,1888,18081,191.0
2020-12-22 00:00:00+00:00,Saarland,377,265,1857,18458,188.0
2020-12-23 00:00:00+00:00,Saarland,340,271,1898,18798,192.0
2020-12-24 00:00:00+00:00,Saarland,240,251,1762,19038,179.0
2020-12-25 00:00:00+00:00,Saarland,155,231,1621,19193,164.0
2020-12-26 00:00:00+00:00,Saarland,93,216,1517,19286,154.0
2020-12-27 00:00:00+00:00,Saarland,95,217,1520,19381,154.0
2020-12-28 00:00:00+00:00,Saarland,69,195,1369,19450,139.0
2020-12-29 00:00:00+00:00,Saarland,315,186,1307,19765,132.0
2020-12-30 00:00:00+00:00,Saarland,236,171,1203,20001,122.0
2020-12-31 00:00:00+00:00,Saarland,151,159,1114,20152,113.0
2021-01-01 00:00:00+00:00,Saarland,65,146,1024,20217,104.0
2021-01-02 00:00:00+00:00,Saarland,36,138,967,20253,98.0
2021-01-03 00:00:00+00:00,Saarland,95,138,967,20348,98.0
2021-01-04 00:00:00+00:00,Saarland,96,142,994,20444,101.0
2021-01-05 00:00:00+00:00,Saarland,217,128,896,20661,91.0
2021-01-06 00:00:00+00:00,Saarland,451,158,1111,21112,113.0
2021-01-07 00:00:00+00:00,Saarland,424,197,1384,21536,140.0
2021-01-08 00:00:00+00:00,Saarland,420,248,1739,21956,176.0
2021-01-09 00:00:00+00:00,Saarland,290,284,1993,22246,202.0
2021-01-10 00:00:00+00:00,Saarland,59,279,1957,22305,198.0
2021-01-11 00:00:00+00:00,Saarland,73,276,1934,22378,196.0
2021-01-12 00:00:00+00:00,Saarland,173,270,1890,22551,192.0
2021-01-13 00:00:00+00:00,Saarland,224,237,1663,22775,169.0
2021-01-14 00:00:00+00:00,Saarland,212,207,1451,22987,147.0
2021-01-15 00:00:00+00:00,Saarland,212,177,1243,23199,126.0
2021-01-16 00:00:00+00:00,Saarland,148,157,1101,23347,112.0
2021-01-17 00:00:00+00:00,Saarland,30,153,1072,23377,109.0
2021-01-18 00:00:00+00:00,Saarland,80,154,1079,23457,109.0
2021-01-19 00:00:00+00:00,Saarland,219,160,1125,23676,114.0
2021-01-20 00:00:00+00:00,Saarland,213,159,1114,23889,113.0
2021-01-21 00:00:00+00:00,Saarland,238,162,1140,24127,116.0
2021-01-22 00:00:00+00:00,Saarland,173,157,1101,24300,112.0
2021-01-23 00:00:00+00:00,Saarland,163,159,1116,24463,113.0
2021-01-24 00:00:00+00:00,Saarland,52,162,1138,24515,115.0
2021-01-25 00:00:00+00:00,Saarland,67,160,1125,24582,114.0
2021-01-26 00:00:00+00:00,Saarland,246,164,1152,24828,117.0
2021-01-27 00:00:00+00:00,Saarland,197,162,1136,25025,115.0
2021-01-28 00:00:00+00:00,Saarland,270,166,1168,25295,118.0
2021-01-29 00:00:00+00:00,Saarland,223,174,1218,25518,123.0
2021-01-30 00:00:00+00:00,Saarland,178,176,1233,25696,125.0
2021-01-31 00:00:00+00:00,Saarland,62,177,1243,25758,126.0
2021-02-01 00:00:00+00:00,Saarland,58,176,1234,25816,125.0
2021-02-02 00:00:00+00:00,Saarland,225,173,1213,26041,123.0
2021-02-03 00:00:00+00:00,Saarland,263,182,1279,26304,130.0
2021-02-04 00:00:00+00:00,Saarland,218,175,1227,26522,124.0
2021-02-05 00:00:00+00:00,Saarland,199,171,1203,26721,122.0
2021-02-06 00:00:00+00:00,Saarland,124,164,1149,26845,116.0
2021-02-07 00:00:00+00:00,Saarland,38,160,1125,26883,114.0
2021-02-08 00:00:00+00:00,Saarland,70,162,1137,26953,115.0
2021-02-09 00:00:00+00:00,Saarland,135,149,1047,27088,106.0
2021-02-10 00:00:00+00:00,Saarland,160,134,944,27248,96.0
2021-02-11 00:00:00+00:00,Saarland,151,125,877,27399,89.0
2021-02-12 00:00:00+00:00,Saarland,118,113,796,27517,81.0
2021-02-13 00:00:00+00:00,Saarland,53,103,725,27570,73.0
2021-02-14 00:00:00+00:00,Saarland,25,101,712,27595,72.0
2021-02-15 00:00:00+00:00,Saarland,64,100,706,27659,72.0
2021-02-16 00:00:00+00:00,Saarland,79,92,650,27738,66.0
2021-02-17 00:00:00+00:00,Saarland,123,87,613,27861,62.0
2021-02-18 00:00:00+00:00,Saarland,117,82,579,27978,59.0
2021-02-19 00:00:00+00:00,Saarland,104,80,565,28082,57.0
2021-02-20 00:00:00+00:00,Saarland,82,84,594,28164,60.0
2021-02-21 00:00:00+00:00,Saarland,35,86,604,28199,61.0
2021-02-22 00:00:00+00:00,Saarland,63,86,603,28262,61.0
2021-02-23 00:00:00+00:00,Saarland,115,91,639,28377,65.0
2021-02-24 00:00:00+00:00,Saarland,139,93,655,28516,66.0
2021-02-25 00:00:00+00:00,Saarland,151,98,689,28667,70.0
2021-02-26 00:00:00+00:00,Saarland,134,102,719,28801,73.0
2021-02-27 00:00:00+00:00,Saarland,93,104,730,28894,74.0
2021-02-28 00:00:00+00:00,Saarland,30,103,725,28924,73.0
2021-03-01 00:00:00+00:00,Saarland,50,101,712,28974,72.0
2021-03-02 00:00:00+00:00,Saarland,126,103,723,29100,73.0
2021-03-03 00:00:00+00:00,Saarland,105,98,689,29205,70.0
2021-03-04 00:00:00+00:00,Saarland,96,90,634,29301,64.0
2021-03-05 00:00:00+00:00,Saarland,82,83,582,29383,59.0
2021-03-06 00:00:00+00:00,Saarland,102,84,591,29485,60.0
2021-03-07 00:00:00+00:00,Saarland,24,83,585,29509,59.0
2021-03-08 00:00:00+00:00,Saarland,62,85,597,29571,60.0
2021-03-09 00:00:00+00:00,Saarland,105,82,576,29676,58.0
2021-03-10 00:00:00+00:00,Saarland,119,84,590,29795,60.0
2021-03-11 00:00:00+00:00,Saarland,92,83,586,29887,59.0
2021-03-12 00:00:00+00:00,Saarland,80,83,584,29967,59.0
2021-03-13 00:00:00+00:00,Saarland,86,81,568,30053,58.0
2021-03-14 00:00:00+00:00,Saarland,36,82,580,30089,59.0
2021-03-15 00:00:00+00:00,Saarland,68,83,586,30157,59.0
2021-03-16 00:00:00+00:00,Saarland,132,87,613,30289,62.0
2021-03-17 00:00:00+00:00,Saarland,103,85,597,30392,60.0
2021-03-18 00:00:00+00:00,Saarland,135,91,640,30527,65.0
2021-03-19 00:00:00+00:00,Saarland,92,93,652,30619,66.0
2021-03-20 00:00:00+00:00,Saarland,100,95,666,30719,67.0
2021-03-21 00:00:00+00:00,Saarland,35,95,665,30754,67.0
2021-03-22 00:00:00+00:00,Saarland,67,94,664,30821,67.0
2021-03-23 00:00:00+00:00,Saarland,132,94,664,30953,67.0
2021-03-24 00:00:00+00:00,Saarland,139,100,700,31092,71.0
2021-03-25 00:00:00+00:00,Saarland,131,99,696,31223,71.0
2021-03-26 00:00:00+00:00,Saarland,135,105,739,31358,75.0
2021-03-27 00:00:00+00:00,Saarland,146,112,785,31504,80.0
2021-03-28 00:00:00+00:00,Saarland,39,112,789,31543,80.0
2021-03-29 00:00:00+00:00,Saarland,61,111,783,31604,79.0
2021-03-30 00:00:00+00:00,Saarland,186,119,837,31790,85.0
2021-03-31 00:00:00+00:00,Saarland,204,128,902,31994,91.0
2021-04-01 00:00:00+00:00,Saarland,156,132,927,32150,94.0
2021-04-02 00:00:00+00:00,Saarland,132,132,924,32282,94.0
2021-04-03 00:00:00+00:00,Saarland,87,123,865,32369,88.0
2021-04-04 00:00:00+00:00,Saarland,58,126,884,32427,90.0
2021-04-05 00:00:00+00:00,Saarland,62,126,885,32489,90.0
2021-04-06 00:00:00+00:00,Saarland,112,115,811,32601,82.0
2021-04-07 00:00:00+00:00,Saarland,265,124,872,32866,88.0
2021-04-08 00:00:00+00:00,Saarland,263,139,979,33129,99.0
2021-04-09 00:00:00+00:00,Saarland,204,150,1051,33333,106.0
2021-04-10 00:00:00+00:00,Saarland,211,167,1175,33544,119.0
2021-04-11 00:00:00+00:00,Saarland,60,168,1177,33604,119.0
2021-04-12 00:00:00+00:00,Saarland,84,171,1199,33688,121.0
2021-04-13 00:00:00+00:00,Saarland,209,185,1296,33897,131.0
2021-04-14 00:00:00+00:00,Saarland,253,183,1284,34150,130.0
2021-04-15 00:00:00+00:00,Saarland,251,181,1272,34401,129.0
2021-04-16 00:00:00+00:00,Saarland,233,185,1301,34634,132.0
2021-04-17 00:00:00+00:00,Saarland,186,182,1276,34820,129.0
2021-04-18 00:00:00+00:00,Saarland,63,182,1279,34883,130.0
2021-04-19 00:00:00+00:00,Saarland,104,185,1299,34987,132.0
2021-04-20 00:00:00+00:00,Saarland,283,196,1373,35270,139.0
2021-04-21 00:00:00+00:00,Saarland,323,206,1443,35593,146.0
2021-04-22 00:00:00+00:00,Saarland,244,205,1436,35837,146.0
2021-04-23 00:00:00+00:00,Saarland,271,210,1474,36108,149.0
2021-04-24 00:00:00+00:00,Saarland,163,207,1451,36271,147.0
2021-04-25 00:00:00+00:00,Saarland,45,204,1433,36316,145.0
2021-04-26 00:00:00+00:00,Saarland,139,209,1468,36455,149.0
2021-04-27 00:00:00+00:00,Saarland,282,209,1467,36737,149.0
2021-04-28 00:00:00+00:00,Saarland,297,205,1441,37034,146.0
2021-04-29 00:00:00+00:00,Saarland,274,210,1471,37308,149.0
2021-04-30 00:00:00+00:00,Saarland,235,205,1435,37543,145.0
2021-05-01 00:00:00+00:00,Saarland,153,203,1425,37696,144.0
2021-05-02 00:00:00+00:00,Saarland,40,202,1420,37736,144.0
2021-05-03 00:00:00+00:00,Saarland,83,194,1364,37819,138.0
2021-05-04 00:00:00+00:00,Saarland,189,181,1271,38008,129.0
2021-05-05 00:00:00+00:00,Saarland,250,174,1224,38258,124.0
2021-05-06 00:00:00+00:00,Saarland,192,163,1142,38450,116.0
2021-05-07 00:00:00+00:00,Saarland,153,151,1060,38603,107.0
2021-05-08 00:00:00+00:00,Saarland,162,152,1069,38765,108.0
2021-05-09 00:00:00+00:00,Saarland,42,153,1071,38807,109.0
2021-05-10 00:00:00+00:00,Saarland,65,150,1053,38872,107.0
2021-05-11 00:00:00+00:00,Saarland,209,153,1073,39081,109.0
2021-05-12 00:00:00+00:00,Saarland,200,146,1023,39281,104.0
2021-05-13 00:00:00+00:00,Saarland,175,143,1006,39456,102.0
2021-05-14 00:00:00+00:00,Saarland,42,127,895,39498,91.0
2021-05-15 00:00:00+00:00,Saarland,145,125,878,39643,89.0
2021-05-16 00:00:00+00:00,Saarland,34,124,870,39677,88.0
2021-05-17 00:00:00+00:00,Saarland,49,122,854,39726,87.0
2021-05-18 00:00:00+00:00,Saarland,180,117,825,39906,84.0
2021-05-19 00:00:00+00:00,Saarland,147,110,772,40053,78.0
2021-05-20 00:00:00+00:00,Saarland,136,104,733,40189,74.0
2021-05-21 00:00:00+00:00,Saarland,135,118,826,40324,84.0
2021-05-22 00:00:00+00:00,Saarland,120,114,801,40444,81.0
2021-05-23 00:00:00+00:00,Saarland,10,111,777,40454,79.0
2021-05-24 00:00:00+00:00,Saarland,19,106,747,40473,76.0
2021-05-25 00:00:00+00:00,Saarland,50,88,617,40523,63.0
2021-05-26 00:00:00+00:00,Saarland,67,76,537,40590,54.0
2021-05-27 00:00:00+00:00,Saarland,76,68,477,40666,48.0
2021-05-28 00:00:00+00:00,Saarland,66,58,408,40732,41.0
2021-05-29 00:00:00+00:00,Saarland,52,48,340,40784,34.0
2021-05-30 00:00:00+00:00,Saarland,12,48,342,40796,35.0
2021-05-31 00:00:00+00:00,Saarland,25,49,348,40821,35.0
2021-06-01 00:00:00+00:00,Saarland,96,56,394,40917,40.0
2021-06-02 00:00:00+00:00,Saarland,65,56,392,40982,40.0
2021-06-03 00:00:00+00:00,Saarland,44,51,360,41026,36.0
2021-06-04 00:00:00+00:00,Saarland,22,45,316,41048,32.0
2021-06-05 00:00:00+00:00,Saarland,34,42,298,41082,30.0
2021-06-06 00:00:00+00:00,Saarland,13,42,299,41095,30.0
2021-06-07 00:00:00+00:00,Saarland,8,40,282,41103,29.0
2021-06-08 00:00:00+00:00,Saarland,43,32,229,41146,23.0
2021-06-09 00:00:00+00:00,Saarland,50,30,214,41196,22.0
2021-06-10 00:00:00+00:00,Saarland,32,28,202,41228,20.0
2021-06-11 00:00:00+00:00,Saarland,32,30,212,41260,21.0
2021-06-12 00:00:00+00:00,Saarland,31,29,209,41291,21.0
2021-06-13 00:00:00+00:00,Saarland,8,29,204,41299,21.0
2021-06-14 00:00:00+00:00,Saarland,6,28,202,41305,20.0
2021-06-15 00:00:00+00:00,Saarland,33,27,192,41338,19.0
2021-06-16 00:00:00+00:00,Saarland,23,23,165,41361,17.0
2021-06-17 00:00:00+00:00,Saarland,14,21,147,41375,15.0
2021-06-18 00:00:00+00:00,Saarland,23,19,138,41398,14.0
2021-06-19 00:00:00+00:00,Saarland,19,18,126,41417,13.0
2021-06-20 00:00:00+00:00,Saarland,1,17,119,41418,12.0
2021-06-21 00:00:00+00:00,Saarland,6,17,119,41424,12.0
2021-06-22 00:00:00+00:00,Saarland,16,14,102,41440,10.0
2021-06-23 00:00:00+00:00,Saarland,13,13,92,41453,9.0
2021-06-24 00:00:00+00:00,Saarland,19,13,97,41472,10.0
2021-06-25 00:00:00+00:00,Saarland,8,11,82,41480,8.0
2021-06-26 00:00:00+00:00,Saarland,6,9,69,41486,7.0
2021-06-27 00:00:00+00:00,Saarland,2,10,70,41488,7.0
2021-06-28 00:00:00+00:00,Saarland,8,10,72,41496,7.0
2021-06-29 00:00:00+00:00,Saarland,11,9,67,41507,7.0
2021-06-30 00:00:00+00:00,Saarland,14,9,68,41521,7.0
2021-07-01 00:00:00+00:00,Saarland,8,8,57,41529,6.0
2021-07-02 00:00:00+00:00,Saarland,16,9,65,41545,7.0
2021-07-03 00:00:00+00:00,Saarland,5,9,64,41550,6.0
2021-07-04 00:00:00+00:00,Saarland,2,9,64,41552,6.0
2021-07-05 00:00:00+00:00,Saarland,2,8,58,41554,6.0
2021-07-06 00:00:00+00:00,Saarland,22,9,69,41576,7.0
2020-01-28 00:00:00+00:00,Bayern,2,0,0,2,0.0
2020-01-29 00:00:00+00:00,Bayern,2,0,0,4,0.0
2020-01-31 00:00:00+00:00,Bayern,3,0,0,7,0.0
2020-02-01 00:00:00+00:00,Bayern,1,0,0,8,0.0
2020-02-03 00:00:00+00:00,Bayern,1,0,0,9,0.0
2020-02-04 00:00:00+00:00,Bayern,3,0,0,12,0.0
2020-02-06 00:00:00+00:00,Bayern,1,1,13,13,0.0
2020-02-07 00:00:00+00:00,Bayern,1,1,12,14,0.0
2020-02-11 00:00:00+00:00,Bayern,2,1,12,16,0.0
2020-02-20 00:00:00+00:00,Bayern,1,1,10,17,0.0
2020-02-27 00:00:00+00:00,Bayern,1,1,10,18,0.0
2020-02-28 00:00:00+00:00,Bayern,2,1,11,20,0.0
2020-02-29 00:00:00+00:00,Bayern,2,1,10,22,0.0
2020-03-01 00:00:00+00:00,Bayern,4,1,13,26,0.0
2020-03-02 00:00:00+00:00,Bayern,6,2,18,32,0.0
2020-03-03 00:00:00+00:00,Bayern,6,3,22,38,0.0
2020-03-04 00:00:00+00:00,Bayern,10,4,31,48,0.0
2020-03-05 00:00:00+00:00,Bayern,19,7,49,67,0.0
2020-03-06 00:00:00+00:00,Bayern,51,14,98,118,1.0
2020-03-07 00:00:00+00:00,Bayern,20,16,116,138,1.0
2020-03-08 00:00:00+00:00,Bayern,20,18,132,158,1.0
2020-03-09 00:00:00+00:00,Bayern,87,30,213,245,2.0
2020-03-10 00:00:00+00:00,Bayern,111,45,318,356,2.0
2020-03-11 00:00:00+00:00,Bayern,120,61,428,476,3.0
2020-03-12 00:00:00+00:00,Bayern,135,77,544,611,4.0
2020-03-13 00:00:00+00:00,Bayern,252,106,745,863,6.0
2020-03-14 00:00:00+00:00,Bayern,231,136,956,1094,7.0
2020-03-15 00:00:00+00:00,Bayern,169,157,1105,1263,8.0
2020-03-16 00:00:00+00:00,Bayern,270,184,1288,1533,10.0
2020-03-17 00:00:00+00:00,Bayern,472,235,1649,2005,13.0
2020-03-18 00:00:00+00:00,Bayern,754,326,2283,2759,17.0
2020-03-19 00:00:00+00:00,Bayern,821,424,2969,3580,23.0
2020-03-20 00:00:00+00:00,Bayern,866,511,3583,4446,27.0
2020-03-21 00:00:00+00:00,Bayern,1110,637,4462,5556,34.0
2020-03-22 00:00:00+00:00,Bayern,560,693,4853,6116,37.0
2020-03-23 00:00:00+00:00,Bayern,722,757,5305,6838,40.0
2020-03-24 00:00:00+00:00,Bayern,1219,864,6052,8057,46.0
2020-03-25 00:00:00+00:00,Bayern,1678,996,6976,9735,53.0
2020-03-26 00:00:00+00:00,Bayern,1703,1122,7858,11438,60.0
2020-03-27 00:00:00+00:00,Bayern,1642,1233,8634,13080,66.0
2020-03-28 00:00:00+00:00,Bayern,1416,1277,8940,14496,68.0
2020-03-29 00:00:00+00:00,Bayern,861,1320,9241,15357,70.0
2020-03-30 00:00:00+00:00,Bayern,1039,1365,9558,16396,73.0
2020-03-31 00:00:00+00:00,Bayern,1841,1454,10180,18237,78.0
2020-04-01 00:00:00+00:00,Bayern,1988,1498,10490,20225,80.0
2020-04-02 00:00:00+00:00,Bayern,1946,1533,10733,22171,82.0
2020-04-03 00:00:00+00:00,Bayern,1856,1563,10947,24027,83.0
2020-04-04 00:00:00+00:00,Bayern,1493,1574,11024,25520,84.0
2020-04-05 00:00:00+00:00,Bayern,719,1554,10882,26239,83.0
2020-04-06 00:00:00+00:00,Bayern,1126,1567,10969,27365,84.0
2020-04-07 00:00:00+00:00,Bayern,1533,1523,10661,28898,81.0
2020-04-08 00:00:00+00:00,Bayern,1546,1459,10219,30444,78.0
2020-04-09 00:00:00+00:00,Bayern,1264,1362,9537,31708,73.0
2020-04-10 00:00:00+00:00,Bayern,943,1232,8624,32651,66.0
2020-04-11 00:00:00+00:00,Bayern,763,1127,7894,33414,60.0
2020-04-12 00:00:00+00:00,Bayern,420,1085,7595,33834,58.0
2020-04-13 00:00:00+00:00,Bayern,464,990,6933,34298,53.0
2020-04-14 00:00:00+00:00,Bayern,751,878,6151,35049,47.0
2020-04-15 00:00:00+00:00,Bayern,963,795,5568,36012,42.0
2020-04-16 00:00:00+00:00,Bayern,861,737,5165,36873,39.0
2020-04-17 00:00:00+00:00,Bayern,775,713,4997,37648,38.0
2020-04-18 00:00:00+00:00,Bayern,521,679,4755,38169,36.0
2020-04-19 00:00:00+00:00,Bayern,385,674,4720,38554,36.0
2020-04-20 00:00:00+00:00,Bayern,373,661,4629,38927,35.0
2020-04-21 00:00:00+00:00,Bayern,502,625,4380,39429,33.0
2020-04-22 00:00:00+00:00,Bayern,594,573,4011,40023,31.0
2020-04-23 00:00:00+00:00,Bayern,572,531,3722,40595,28.0
2020-04-24 00:00:00+00:00,Bayern,527,496,3474,41122,26.0
2020-04-25 00:00:00+00:00,Bayern,309,466,3262,41431,25.0
2020-04-26 00:00:00+00:00,Bayern,186,437,3063,41617,23.0
2020-04-27 00:00:00+00:00,Bayern,339,432,3029,41956,23.0
2020-04-28 00:00:00+00:00,Bayern,362,412,2889,42318,22.0
2020-04-29 00:00:00+00:00,Bayern,302,371,2597,42620,20.0
2020-04-30 00:00:00+00:00,Bayern,291,330,2316,42911,18.0
2020-05-01 00:00:00+00:00,Bayern,221,287,2010,43132,15.0
2020-05-02 00:00:00+00:00,Bayern,138,262,1839,43270,14.0
2020-05-03 00:00:00+00:00,Bayern,91,249,1744,43361,13.0
2020-05-04 00:00:00+00:00,Bayern,165,224,1570,43526,12.0
2020-05-05 00:00:00+00:00,Bayern,211,202,1419,43737,11.0
2020-05-06 00:00:00+00:00,Bayern,266,197,1383,44003,11.0
2020-05-07 00:00:00+00:00,Bayern,233,189,1325,44236,10.0
2020-05-08 00:00:00+00:00,Bayern,209,187,1313,44445,10.0
2020-05-09 00:00:00+00:00,Bayern,122,185,1297,44567,10.0
2020-05-10 00:00:00+00:00,Bayern,78,183,1284,44645,10.0
2020-05-11 00:00:00+00:00,Bayern,188,186,1307,44833,10.0
2020-05-12 00:00:00+00:00,Bayern,213,187,1309,45046,10.0
2020-05-13 00:00:00+00:00,Bayern,188,175,1231,45234,9.0
2020-05-14 00:00:00+00:00,Bayern,208,172,1206,45442,9.0
2020-05-15 00:00:00+00:00,Bayern,135,161,1132,45577,9.0
2020-05-16 00:00:00+00:00,Bayern,101,158,1111,45678,8.0
2020-05-17 00:00:00+00:00,Bayern,58,155,1091,45736,8.0
2020-05-18 00:00:00+00:00,Bayern,88,141,991,45824,8.0
2020-05-19 00:00:00+00:00,Bayern,108,126,886,45932,7.0
2020-05-20 00:00:00+00:00,Bayern,194,127,892,46126,7.0
2020-05-21 00:00:00+00:00,Bayern,93,111,777,46219,6.0
2020-05-22 00:00:00+00:00,Bayern,117,108,759,46336,6.0
2020-05-23 00:00:00+00:00,Bayern,78,105,736,46414,6.0
2020-05-24 00:00:00+00:00,Bayern,87,109,765,46501,6.0
2020-05-25 00:00:00+00:00,Bayern,88,109,765,46589,6.0
2020-05-26 00:00:00+00:00,Bayern,134,113,791,46723,6.0
2020-05-27 00:00:00+00:00,Bayern,115,101,712,46838,5.0
2020-05-28 00:00:00+00:00,Bayern,87,100,706,46925,5.0
2020-05-29 00:00:00+00:00,Bayern,77,95,666,47002,5.0
2020-05-30 00:00:00+00:00,Bayern,83,95,671,47085,5.0
2020-05-31 00:00:00+00:00,Bayern,37,88,621,47122,5.0
2020-06-01 00:00:00+00:00,Bayern,20,79,553,47142,4.0
2020-06-02 00:00:00+00:00,Bayern,37,65,456,47179,3.0
2020-06-03 00:00:00+00:00,Bayern,54,56,395,47233,3.0
2020-06-04 00:00:00+00:00,Bayern,84,56,392,47317,3.0
2020-06-05 00:00:00+00:00,Bayern,56,53,371,47373,3.0
2020-06-06 00:00:00+00:00,Bayern,23,44,311,47396,2.0
2020-06-07 00:00:00+00:00,Bayern,37,44,311,47433,2.0
2020-06-08 00:00:00+00:00,Bayern,41,47,332,47474,3.0
2020-06-09 00:00:00+00:00,Bayern,45,48,340,47519,3.0
2020-06-10 00:00:00+00:00,Bayern,75,51,361,47594,3.0
2020-06-11 00:00:00+00:00,Bayern,35,44,312,47629,2.0
2020-06-12 00:00:00+00:00,Bayern,33,41,289,47662,2.0
2020-06-13 00:00:00+00:00,Bayern,22,41,288,47684,2.0
2020-06-14 00:00:00+00:00,Bayern,18,38,269,47702,2.0
2020-06-15 00:00:00+00:00,Bayern,35,37,263,47737,2.0
2020-06-16 00:00:00+00:00,Bayern,43,37,261,47780,2.0
2020-06-17 00:00:00+00:00,Bayern,43,32,229,47823,2.0
2020-06-18 00:00:00+00:00,Bayern,46,34,240,47869,2.0
2020-06-19 00:00:00+00:00,Bayern,41,35,248,47910,2.0
2020-06-20 00:00:00+00:00,Bayern,33,37,259,47943,2.0
2020-06-21 00:00:00+00:00,Bayern,28,38,269,47971,2.0
2020-06-22 00:00:00+00:00,Bayern,41,39,275,48012,2.0
2020-06-23 00:00:00+00:00,Bayern,48,40,280,48060,2.0
2020-06-24 00:00:00+00:00,Bayern,56,41,293,48116,2.0
2020-06-25 00:00:00+00:00,Bayern,59,43,306,48175,2.0
2020-06-26 00:00:00+00:00,Bayern,87,50,352,48262,3.0
2020-06-27 00:00:00+00:00,Bayern,43,51,362,48305,3.0
2020-06-28 00:00:00+00:00,Bayern,31,52,365,48336,3.0
2020-06-29 00:00:00+00:00,Bayern,62,55,386,48398,3.0
2020-06-30 00:00:00+00:00,Bayern,86,60,424,48484,3.0
2020-07-01 00:00:00+00:00,Bayern,63,61,431,48547,3.0
2020-07-02 00:00:00+00:00,Bayern,69,63,441,48616,3.0
2020-07-03 00:00:00+00:00,Bayern,83,62,437,48699,3.0
2020-07-04 00:00:00+00:00,Bayern,69,66,463,48768,4.0
2020-07-05 00:00:00+00:00,Bayern,28,65,460,48796,4.0
2020-07-06 00:00:00+00:00,Bayern,84,68,482,48880,4.0
2020-07-07 00:00:00+00:00,Bayern,91,69,487,48971,4.0
2020-07-08 00:00:00+00:00,Bayern,71,70,495,49042,4.0
2020-07-09 00:00:00+00:00,Bayern,89,73,515,49131,4.0
2020-07-10 00:00:00+00:00,Bayern,91,74,523,49222,4.0
2020-07-11 00:00:00+00:00,Bayern,61,73,515,49283,4.0
2020-07-12 00:00:00+00:00,Bayern,18,72,505,49301,4.0
2020-07-13 00:00:00+00:00,Bayern,61,68,482,49362,4.0
2020-07-14 00:00:00+00:00,Bayern,86,68,477,49448,4.0
2020-07-15 00:00:00+00:00,Bayern,107,73,513,49555,4.0
2020-07-16 00:00:00+00:00,Bayern,98,74,522,49653,4.0
2020-07-17 00:00:00+00:00,Bayern,79,72,510,49732,4.0
2020-07-18 00:00:00+00:00,Bayern,50,71,499,49782,4.0
2020-07-19 00:00:00+00:00,Bayern,43,74,524,49825,4.0
2020-07-20 00:00:00+00:00,Bayern,78,77,541,49903,4.0
2020-07-21 00:00:00+00:00,Bayern,85,77,540,49988,4.0
2020-07-22 00:00:00+00:00,Bayern,79,73,512,50067,4.0
2020-07-23 00:00:00+00:00,Bayern,100,73,514,50167,4.0
2020-07-24 00:00:00+00:00,Bayern,134,81,569,50301,4.0
2020-07-25 00:00:00+00:00,Bayern,154,96,673,50455,5.0
2020-07-26 00:00:00+00:00,Bayern,85,102,715,50540,5.0
2020-07-27 00:00:00+00:00,Bayern,75,101,712,50615,5.0
2020-07-28 00:00:00+00:00,Bayern,102,104,729,50717,6.0
2020-07-29 00:00:00+00:00,Bayern,118,109,768,50835,6.0
2020-07-30 00:00:00+00:00,Bayern,101,109,769,50936,6.0
2020-07-31 00:00:00+00:00,Bayern,145,111,780,51081,6.0
2020-08-01 00:00:00+00:00,Bayern,72,99,698,51153,5.0
2020-08-02 00:00:00+00:00,Bayern,70,97,683,51223,5.0
2020-08-03 00:00:00+00:00,Bayern,125,104,733,51348,6.0
2020-08-04 00:00:00+00:00,Bayern,170,114,801,51518,6.0
2020-08-05 00:00:00+00:00,Bayern,117,114,800,51635,6.0
2020-08-06 00:00:00+00:00,Bayern,133,118,832,51768,6.0
2020-08-07 00:00:00+00:00,Bayern,79,109,766,51847,6.0
2020-08-08 00:00:00+00:00,Bayern,48,106,742,51895,6.0
2020-08-09 00:00:00+00:00,Bayern,33,100,705,51928,5.0
2020-08-10 00:00:00+00:00,Bayern,183,109,763,52111,6.0
2020-08-11 00:00:00+00:00,Bayern,178,110,771,52289,6.0
2020-08-12 00:00:00+00:00,Bayern,203,122,857,52492,7.0
2020-08-13 00:00:00+00:00,Bayern,238,137,962,52730,7.0
2020-08-14 00:00:00+00:00,Bayern,217,157,1100,52947,8.0
2020-08-15 00:00:00+00:00,Bayern,89,163,1141,53036,9.0
2020-08-16 00:00:00+00:00,Bayern,162,181,1270,53198,10.0
2020-08-17 00:00:00+00:00,Bayern,370,208,1457,53568,11.0
2020-08-18 00:00:00+00:00,Bayern,312,227,1591,53880,12.0
2020-08-19 00:00:00+00:00,Bayern,397,255,1785,54277,14.0
2020-08-20 00:00:00+00:00,Bayern,395,277,1942,54672,15.0
2020-08-21 00:00:00+00:00,Bayern,313,291,2038,54985,16.0
2020-08-22 00:00:00+00:00,Bayern,192,305,2141,55177,16.0
2020-08-23 00:00:00+00:00,Bayern,123,300,2102,55300,16.0
2020-08-24 00:00:00+00:00,Bayern,356,298,2088,55656,16.0
2020-08-25 00:00:00+00:00,Bayern,334,301,2110,55990,16.0
2020-08-26 00:00:00+00:00,Bayern,491,314,2204,56481,17.0
2020-08-27 00:00:00+00:00,Bayern,410,317,2219,56891,17.0
2020-08-28 00:00:00+00:00,Bayern,284,312,2190,57175,17.0
2020-08-29 00:00:00+00:00,Bayern,175,310,2173,57350,17.0
2020-08-30 00:00:00+00:00,Bayern,113,309,2163,57463,16.0
2020-08-31 00:00:00+00:00,Bayern,276,297,2083,57739,16.0
2020-09-01 00:00:00+00:00,Bayern,332,297,2081,58071,16.0
2020-09-02 00:00:00+00:00,Bayern,346,276,1936,58417,15.0
2020-09-03 00:00:00+00:00,Bayern,397,274,1923,58814,15.0
2020-09-04 00:00:00+00:00,Bayern,386,289,2025,59200,15.0
2020-09-05 00:00:00+00:00,Bayern,309,308,2159,59509,16.0
2020-09-06 00:00:00+00:00,Bayern,203,321,2249,59712,17.0
2020-09-07 00:00:00+00:00,Bayern,427,342,2400,60139,18.0
2020-09-08 00:00:00+00:00,Bayern,464,361,2532,60603,19.0
2020-09-09 00:00:00+00:00,Bayern,533,388,2719,61136,21.0
2020-09-10 00:00:00+00:00,Bayern,397,388,2719,61533,21.0
2020-09-11 00:00:00+00:00,Bayern,360,384,2693,61893,21.0
2020-09-12 00:00:00+00:00,Bayern,257,377,2641,62150,20.0
2020-09-13 00:00:00+00:00,Bayern,217,379,2655,62367,20.0
2020-09-14 00:00:00+00:00,Bayern,395,374,2623,62762,20.0
2020-09-15 00:00:00+00:00,Bayern,547,386,2706,63309,21.0
2020-09-16 00:00:00+00:00,Bayern,517,384,2690,63826,20.0
2020-09-17 00:00:00+00:00,Bayern,534,403,2827,64360,22.0
2020-09-18 00:00:00+00:00,Bayern,459,418,2926,64819,22.0
2020-09-19 00:00:00+00:00,Bayern,309,425,2978,65128,23.0
2020-09-20 00:00:00+00:00,Bayern,166,418,2927,65294,22.0
2020-09-21 00:00:00+00:00,Bayern,389,417,2921,65683,22.0
2020-09-22 00:00:00+00:00,Bayern,341,387,2715,66024,21.0
2020-09-23 00:00:00+00:00,Bayern,426,374,2624,66450,20.0
2020-09-24 00:00:00+00:00,Bayern,400,355,2490,66850,19.0
2020-09-25 00:00:00+00:00,Bayern,361,341,2392,67211,18.0
2020-09-26 00:00:00+00:00,Bayern,239,331,2322,67450,18.0
2020-09-27 00:00:00+00:00,Bayern,127,326,2283,67577,17.0
2020-09-28 00:00:00+00:00,Bayern,423,331,2317,68000,18.0
2020-09-29 00:00:00+00:00,Bayern,344,331,2320,68344,18.0
2020-09-30 00:00:00+00:00,Bayern,396,327,2290,68740,17.0
2020-10-01 00:00:00+00:00,Bayern,352,320,2242,69092,17.0
2020-10-02 00:00:00+00:00,Bayern,347,318,2228,69439,17.0
2020-10-03 00:00:00+00:00,Bayern,308,328,2297,69747,18.0
2020-10-04 00:00:00+00:00,Bayern,151,331,2321,69898,18.0
2020-10-05 00:00:00+00:00,Bayern,360,322,2258,70258,17.0
2020-10-06 00:00:00+00:00,Bayern,497,344,2411,70755,18.0
2020-10-07 00:00:00+00:00,Bayern,664,382,2679,71419,20.0
2020-10-08 00:00:00+00:00,Bayern,686,430,3013,72105,23.0
2020-10-09 00:00:00+00:00,Bayern,739,486,3405,72844,26.0
2020-10-10 00:00:00+00:00,Bayern,420,502,3517,73264,27.0
2020-10-11 00:00:00+00:00,Bayern,321,526,3687,73585,28.0
2020-10-12 00:00:00+00:00,Bayern,680,572,4007,74265,31.0
2020-10-13 00:00:00+00:00,Bayern,690,600,4200,74955,32.0
2020-10-14 00:00:00+00:00,Bayern,1153,669,4689,76108,36.0
2020-10-15 00:00:00+00:00,Bayern,1284,755,5287,77392,40.0
2020-10-16 00:00:00+00:00,Bayern,1269,831,5817,78661,44.0
2020-10-17 00:00:00+00:00,Bayern,984,911,6381,79645,49.0
2020-10-18 00:00:00+00:00,Bayern,574,947,6634,80219,51.0
2020-10-19 00:00:00+00:00,Bayern,1077,1004,7031,81296,54.0
2020-10-20 00:00:00+00:00,Bayern,1464,1115,7805,82760,59.0
2020-10-21 00:00:00+00:00,Bayern,2227,1268,8879,84987,68.0
2020-10-22 00:00:00+00:00,Bayern,2236,1404,9831,87223,75.0
2020-10-23 00:00:00+00:00,Bayern,2121,1526,10683,89344,81.0
2020-10-24 00:00:00+00:00,Bayern,1669,1624,11368,91013,87.0
2020-10-25 00:00:00+00:00,Bayern,1413,1743,12207,92426,93.0
2020-10-26 00:00:00+00:00,Bayern,2280,1915,13410,94706,102.0
2020-10-27 00:00:00+00:00,Bayern,2727,2096,14673,97433,112.0
2020-10-28 00:00:00+00:00,Bayern,3114,2222,15560,100547,119.0
2020-10-29 00:00:00+00:00,Bayern,2974,2328,16298,103521,124.0
2020-10-30 00:00:00+00:00,Bayern,3134,2473,17311,106655,132.0
2020-10-31 00:00:00+00:00,Bayern,2615,2608,18257,109270,139.0
2020-11-01 00:00:00+00:00,Bayern,2071,2702,18915,111341,144.0
2020-11-02 00:00:00+00:00,Bayern,2836,2781,19471,114177,148.0
2020-11-03 00:00:00+00:00,Bayern,3429,2881,20173,117606,154.0
2020-11-04 00:00:00+00:00,Bayern,3719,2968,20778,121325,158.0
2020-11-05 00:00:00+00:00,Bayern,3955,3108,21759,125280,166.0
2020-11-06 00:00:00+00:00,Bayern,4487,3301,23112,129767,176.0
2020-11-07 00:00:00+00:00,Bayern,3105,3371,23602,132872,180.0
2020-11-08 00:00:00+00:00,Bayern,2182,3387,23713,135054,181.0
2020-11-09 00:00:00+00:00,Bayern,3036,3416,23913,138090,182.0
2020-11-10 00:00:00+00:00,Bayern,3866,3478,24350,141956,186.0
2020-11-11 00:00:00+00:00,Bayern,4611,3606,25242,146567,192.0
2020-11-12 00:00:00+00:00,Bayern,4590,3696,25877,151157,197.0
2020-11-13 00:00:00+00:00,Bayern,4073,3637,25463,155230,194.0
2020-11-14 00:00:00+00:00,Bayern,3156,3644,25514,158386,194.0
2020-11-15 00:00:00+00:00,Bayern,1528,3551,24860,159914,189.0
2020-11-16 00:00:00+00:00,Bayern,2436,3465,24260,162350,185.0
2020-11-17 00:00:00+00:00,Bayern,3598,3427,23992,165948,183.0
2020-11-18 00:00:00+00:00,Bayern,4768,3449,24149,170716,184.0
2020-11-19 00:00:00+00:00,Bayern,4595,3450,24154,175311,184.0
2020-11-20 00:00:00+00:00,Bayern,4208,3469,24289,179519,185.0
2020-11-21 00:00:00+00:00,Bayern,2779,3416,23912,182298,182.0
2020-11-22 00:00:00+00:00,Bayern,1827,3458,24211,184125,184.0
2020-11-23 00:00:00+00:00,Bayern,3002,3539,24777,187127,189.0
2020-11-24 00:00:00+00:00,Bayern,3845,3574,25024,190972,191.0
2020-11-25 00:00:00+00:00,Bayern,4306,3508,24562,195278,187.0
2020-11-26 00:00:00+00:00,Bayern,4545,3501,24512,199823,187.0
2020-11-27 00:00:00+00:00,Bayern,3814,3445,24118,203637,184.0
2020-11-28 00:00:00+00:00,Bayern,2880,3459,24219,206517,185.0
2020-11-29 00:00:00+00:00,Bayern,2023,3487,24415,208540,186.0
2020-11-30 00:00:00+00:00,Bayern,2647,3437,24060,211187,183.0
2020-12-01 00:00:00+00:00,Bayern,3621,3405,23836,214808,182.0
2020-12-02 00:00:00+00:00,Bayern,4411,3420,23941,219219,182.0
2020-12-03 00:00:00+00:00,Bayern,4554,3421,23950,223773,182.0
2020-12-04 00:00:00+00:00,Bayern,3783,3417,23919,227556,182.0
2020-12-05 00:00:00+00:00,Bayern,2839,3411,23878,230395,182.0
2020-12-06 00:00:00+00:00,Bayern,2433,3469,24288,232828,185.0
2020-12-07 00:00:00+00:00,Bayern,2961,3514,24602,235789,187.0
2020-12-08 00:00:00+00:00,Bayern,4274,3607,25255,240063,192.0
2020-12-09 00:00:00+00:00,Bayern,5006,3692,25850,245069,197.0
2020-12-10 00:00:00+00:00,Bayern,4903,3742,26199,249972,200.0
2020-12-11 00:00:00+00:00,Bayern,4949,3909,27365,254921,208.0
2020-12-12 00:00:00+00:00,Bayern,3377,3986,27903,258298,213.0
2020-12-13 00:00:00+00:00,Bayern,2654,4017,28124,260952,214.0
2020-12-14 00:00:00+00:00,Bayern,3077,4034,28240,264029,215.0
2020-12-15 00:00:00+00:00,Bayern,4797,4109,28763,268826,219.0
2020-12-16 00:00:00+00:00,Bayern,5325,4154,29082,274151,222.0
2020-12-17 00:00:00+00:00,Bayern,5510,4241,29689,279661,226.0
2020-12-18 00:00:00+00:00,Bayern,4755,4213,29495,284416,225.0
2020-12-19 00:00:00+00:00,Bayern,3632,4250,29750,288048,227.0
2020-12-20 00:00:00+00:00,Bayern,2277,4196,29373,290325,224.0
2020-12-21 00:00:00+00:00,Bayern,2787,4154,29083,293112,222.0
2020-12-22 00:00:00+00:00,Bayern,4299,4083,28585,297411,218.0
2020-12-23 00:00:00+00:00,Bayern,5315,4082,28575,302726,218.0
2020-12-24 00:00:00+00:00,Bayern,3472,3791,26537,306198,202.0
2020-12-25 00:00:00+00:00,Bayern,2715,3499,24497,308913,187.0
2020-12-26 00:00:00+00:00,Bayern,2209,3296,23074,311122,176.0
2020-12-27 00:00:00+00:00,Bayern,1705,3214,22502,312827,171.0
2020-12-28 00:00:00+00:00,Bayern,2299,3144,22014,315126,168.0
2020-12-29 00:00:00+00:00,Bayern,4446,3165,22161,319572,169.0
2020-12-30 00:00:00+00:00,Bayern,5664,3215,22510,325236,172.0
2020-12-31 00:00:00+00:00,Bayern,3868,3272,22906,329104,175.0
2021-01-01 00:00:00+00:00,Bayern,1959,3164,22150,331063,169.0
2021-01-02 00:00:00+00:00,Bayern,1814,3107,21755,332877,166.0
2021-01-03 00:00:00+00:00,Bayern,1728,3111,21778,334605,166.0
2021-01-04 00:00:00+00:00,Bayern,2226,3100,21705,336831,165.0
2021-01-05 00:00:00+00:00,Bayern,4272,3075,21531,341103,164.0
2021-01-06 00:00:00+00:00,Bayern,3506,2767,19373,344609,148.0
2021-01-07 00:00:00+00:00,Bayern,3563,2724,19068,348172,145.0
2021-01-08 00:00:00+00:00,Bayern,4091,3028,21200,352263,162.0
2021-01-09 00:00:00+00:00,Bayern,3018,3200,22404,355281,171.0
2021-01-10 00:00:00+00:00,Bayern,1751,3203,22427,357032,171.0
2021-01-11 00:00:00+00:00,Bayern,1908,3158,22109,358940,168.0
2021-01-12 00:00:00+00:00,Bayern,3357,3027,21194,362297,161.0
2021-01-13 00:00:00+00:00,Bayern,4024,3101,21712,366321,165.0
2021-01-14 00:00:00+00:00,Bayern,3293,3063,21442,369614,163.0
2021-01-15 00:00:00+00:00,Bayern,2919,2895,20270,372533,154.0
2021-01-16 00:00:00+00:00,Bayern,2171,2774,19423,374704,148.0
2021-01-17 00:00:00+00:00,Bayern,1286,2708,18958,375990,144.0
2021-01-18 00:00:00+00:00,Bayern,1147,2599,18197,377137,139.0
2021-01-19 00:00:00+00:00,Bayern,2921,2537,17761,380058,135.0
2021-01-20 00:00:00+00:00,Bayern,2866,2371,16603,382924,127.0
2021-01-21 00:00:00+00:00,Bayern,2475,2255,15785,385399,120.0
2021-01-22 00:00:00+00:00,Bayern,2301,2166,15167,387700,116.0
2021-01-23 00:00:00+00:00,Bayern,1765,2108,14761,389465,112.0
2021-01-24 00:00:00+00:00,Bayern,1040,2073,14515,390505,111.0
2021-01-25 00:00:00+00:00,Bayern,757,2017,14125,391262,108.0
2021-01-26 00:00:00+00:00,Bayern,2597,1971,13801,393859,105.0
2021-01-27 00:00:00+00:00,Bayern,2400,1905,13335,396259,102.0
2021-01-28 00:00:00+00:00,Bayern,2158,1859,13018,398417,99.0
2021-01-29 00:00:00+00:00,Bayern,1917,1804,12634,400334,96.0
2021-01-30 00:00:00+00:00,Bayern,1720,1798,12589,402054,96.0
2021-01-31 00:00:00+00:00,Bayern,783,1761,12332,402837,94.0
2021-02-01 00:00:00+00:00,Bayern,714,1755,12289,403551,94.0
2021-02-02 00:00:00+00:00,Bayern,1934,1660,11626,405485,89.0
2021-02-03 00:00:00+00:00,Bayern,2286,1644,11512,407771,88.0
2021-02-04 00:00:00+00:00,Bayern,1803,1593,11157,409574,85.0
2021-02-05 00:00:00+00:00,Bayern,1461,1528,10701,411035,82.0
2021-02-06 00:00:00+00:00,Bayern,1431,1487,10412,412466,79.0
2021-02-07 00:00:00+00:00,Bayern,567,1456,10196,413033,78.0
2021-02-08 00:00:00+00:00,Bayern,464,1420,9946,413497,76.0
2021-02-09 00:00:00+00:00,Bayern,1480,1356,9492,414977,72.0
2021-02-10 00:00:00+00:00,Bayern,1705,1273,8911,416682,68.0
2021-02-11 00:00:00+00:00,Bayern,1393,1214,8501,418075,65.0
2021-02-12 00:00:00+00:00,Bayern,1248,1184,8288,419323,63.0
2021-02-13 00:00:00+00:00,Bayern,812,1095,7669,420135,58.0
2021-02-14 00:00:00+00:00,Bayern,669,1110,7771,420804,59.0
2021-02-15 00:00:00+00:00,Bayern,544,1121,7851,421348,60.0
2021-02-16 00:00:00+00:00,Bayern,1347,1102,7718,422695,59.0
2021-02-17 00:00:00+00:00,Bayern,1639,1093,7652,424334,58.0
2021-02-18 00:00:00+00:00,Bayern,1307,1080,7566,425641,58.0
2021-02-19 00:00:00+00:00,Bayern,1316,1090,7634,426957,58.0
2021-02-20 00:00:00+00:00,Bayern,1048,1124,7870,428005,60.0
2021-02-21 00:00:00+00:00,Bayern,598,1114,7799,428603,59.0
2021-02-22 00:00:00+00:00,Bayern,516,1110,7771,429119,59.0
2021-02-23 00:00:00+00:00,Bayern,1535,1137,7959,430654,61.0
2021-02-24 00:00:00+00:00,Bayern,1637,1136,7957,432291,61.0
2021-02-25 00:00:00+00:00,Bayern,1501,1164,8151,433792,62.0
2021-02-26 00:00:00+00:00,Bayern,1486,1188,8321,435278,63.0
2021-02-27 00:00:00+00:00,Bayern,1463,1248,8736,436741,67.0
2021-02-28 00:00:00+00:00,Bayern,731,1267,8869,437472,68.0
2021-03-01 00:00:00+00:00,Bayern,542,1270,8895,438014,68.0
2021-03-02 00:00:00+00:00,Bayern,1873,1319,9233,439887,70.0
2021-03-03 00:00:00+00:00,Bayern,1799,1342,9395,441686,72.0
2021-03-04 00:00:00+00:00,Bayern,1728,1374,9622,443414,73.0
2021-03-05 00:00:00+00:00,Bayern,1681,1402,9817,445095,75.0
2021-03-06 00:00:00+00:00,Bayern,1313,1381,9667,446408,74.0
2021-03-07 00:00:00+00:00,Bayern,758,1384,9694,447166,74.0
2021-03-08 00:00:00+00:00,Bayern,820,1424,9972,447986,76.0
2021-03-09 00:00:00+00:00,Bayern,1827,1418,9926,449813,76.0
2021-03-10 00:00:00+00:00,Bayern,2462,1512,10589,452275,81.0
2021-03-11 00:00:00+00:00,Bayern,2129,1570,10990,454404,84.0
2021-03-12 00:00:00+00:00,Bayern,1963,1610,11272,456367,86.0
2021-03-13 00:00:00+00:00,Bayern,1663,1660,11622,458030,89.0
2021-03-14 00:00:00+00:00,Bayern,1011,1696,11875,459041,90.0
2021-03-15 00:00:00+00:00,Bayern,967,1717,12022,460008,92.0
2021-03-16 00:00:00+00:00,Bayern,2638,1833,12833,462646,98.0
2021-03-17 00:00:00+00:00,Bayern,3005,1910,13376,465651,102.0
2021-03-18 00:00:00+00:00,Bayern,2571,1974,13818,468222,105.0
2021-03-19 00:00:00+00:00,Bayern,2372,2032,14227,470594,108.0
2021-03-20 00:00:00+00:00,Bayern,2101,2095,14665,472695,112.0
2021-03-21 00:00:00+00:00,Bayern,1286,2134,14940,473981,114.0
2021-03-22 00:00:00+00:00,Bayern,980,2136,14953,474961,114.0
2021-03-23 00:00:00+00:00,Bayern,3184,2214,15499,478145,118.0
2021-03-24 00:00:00+00:00,Bayern,3495,2284,15989,481640,122.0
2021-03-25 00:00:00+00:00,Bayern,3562,2425,16980,485202,129.0
2021-03-26 00:00:00+00:00,Bayern,3306,2559,17914,488508,136.0
2021-03-27 00:00:00+00:00,Bayern,2643,2636,18456,491151,141.0
2021-03-28 00:00:00+00:00,Bayern,1398,2652,18568,492549,141.0
2021-03-29 00:00:00+00:00,Bayern,1394,2711,18982,493943,145.0
2021-03-30 00:00:00+00:00,Bayern,3365,2737,19163,497308,146.0
2021-03-31 00:00:00+00:00,Bayern,4084,2821,19752,501392,150.0
2021-04-01 00:00:00+00:00,Bayern,3224,2773,19414,504616,148.0
2021-04-02 00:00:00+00:00,Bayern,2568,2668,18676,507184,142.0
2021-04-03 00:00:00+00:00,Bayern,1804,2548,17837,508988,136.0
2021-04-04 00:00:00+00:00,Bayern,1360,2542,17799,510348,136.0
2021-04-05 00:00:00+00:00,Bayern,1021,2489,17426,511369,133.0
2021-04-06 00:00:00+00:00,Bayern,2377,2348,16438,513746,125.0
2021-04-07 00:00:00+00:00,Bayern,4359,2387,16713,518105,127.0
2021-04-08 00:00:00+00:00,Bayern,4504,2570,17993,522609,137.0
2021-04-09 00:00:00+00:00,Bayern,3689,2730,19114,526298,146.0
2021-04-10 00:00:00+00:00,Bayern,2973,2897,20283,529271,155.0
2021-04-11 00:00:00+00:00,Bayern,1898,2974,20821,531169,159.0
2021-04-12 00:00:00+00:00,Bayern,1814,3087,21614,532983,165.0
2021-04-13 00:00:00+00:00,Bayern,4677,3416,23914,537660,182.0
2021-04-14 00:00:00+00:00,Bayern,5246,3543,24801,542906,189.0
2021-04-15 00:00:00+00:00,Bayern,4476,3539,24773,547382,189.0
2021-04-16 00:00:00+00:00,Bayern,3904,3569,24988,551286,190.0
2021-04-17 00:00:00+00:00,Bayern,3206,3603,25221,554492,192.0
2021-04-18 00:00:00+00:00,Bayern,1787,3587,25110,556279,191.0
2021-04-19 00:00:00+00:00,Bayern,2049,3620,25345,558328,193.0
2021-04-20 00:00:00+00:00,Bayern,4838,3643,25506,563166,194.0
2021-04-21 00:00:00+00:00,Bayern,4672,3561,24932,567838,190.0
2021-04-22 00:00:00+00:00,Bayern,4271,3532,24727,572109,188.0
2021-04-23 00:00:00+00:00,Bayern,3295,3445,24118,575404,184.0
2021-04-24 00:00:00+00:00,Bayern,3036,3421,23948,578440,182.0
2021-04-25 00:00:00+00:00,Bayern,1724,3412,23885,580164,182.0
2021-04-26 00:00:00+00:00,Bayern,1534,3338,23370,581698,178.0
2021-04-27 00:00:00+00:00,Bayern,4004,3219,22536,585702,172.0
2021-04-28 00:00:00+00:00,Bayern,4182,3149,22046,589884,168.0
2021-04-29 00:00:00+00:00,Bayern,3268,3006,21043,593152,160.0
2021-04-30 00:00:00+00:00,Bayern,2690,2919,20438,595842,156.0
2021-05-01 00:00:00+00:00,Bayern,2363,2823,19765,598205,151.0
2021-05-02 00:00:00+00:00,Bayern,1222,2751,19263,599427,147.0
2021-05-03 00:00:00+00:00,Bayern,1058,2683,18787,600485,143.0
2021-05-04 00:00:00+00:00,Bayern,3339,2588,18122,603824,138.0
2021-05-05 00:00:00+00:00,Bayern,3343,2469,17283,607167,132.0
2021-05-06 00:00:00+00:00,Bayern,2634,2378,16649,609801,127.0
2021-05-07 00:00:00+00:00,Bayern,2444,2343,16403,612245,125.0
2021-05-08 00:00:00+00:00,Bayern,1944,2283,15984,614189,122.0
2021-05-09 00:00:00+00:00,Bayern,993,2250,15755,615182,120.0
2021-05-10 00:00:00+00:00,Bayern,889,2226,15586,616071,119.0
2021-05-11 00:00:00+00:00,Bayern,2650,2128,14897,618721,114.0
2021-05-12 00:00:00+00:00,Bayern,2460,2002,14014,621181,107.0
2021-05-13 00:00:00+00:00,Bayern,1662,1863,13042,622843,99.0
2021-05-14 00:00:00+00:00,Bayern,1160,1679,11758,624003,90.0
2021-05-15 00:00:00+00:00,Bayern,1410,1603,11224,625413,86.0
2021-05-16 00:00:00+00:00,Bayern,915,1592,11146,626328,85.0
2021-05-17 00:00:00+00:00,Bayern,666,1560,10923,626994,83.0
2021-05-18 00:00:00+00:00,Bayern,1876,1449,10149,628870,77.0
2021-05-19 00:00:00+00:00,Bayern,1684,1339,9373,630554,71.0
2021-05-20 00:00:00+00:00,Bayern,1332,1291,9043,631886,69.0
2021-05-21 00:00:00+00:00,Bayern,1072,1279,8955,632958,68.0
2021-05-22 00:00:00+00:00,Bayern,877,1203,8422,633835,64.0
2021-05-23 00:00:00+00:00,Bayern,357,1123,7864,634192,60.0
2021-05-24 00:00:00+00:00,Bayern,337,1076,7535,634529,57.0
2021-05-25 00:00:00+00:00,Bayern,570,889,6229,635099,47.0
2021-05-26 00:00:00+00:00,Bayern,1175,817,5720,636274,44.0
2021-05-27 00:00:00+00:00,Bayern,1109,785,5497,637383,42.0
2021-05-28 00:00:00+00:00,Bayern,728,736,5153,638111,39.0
2021-05-29 00:00:00+00:00,Bayern,561,691,4837,638672,37.0
2021-05-30 00:00:00+00:00,Bayern,380,694,4860,639052,37.0
2021-05-31 00:00:00+00:00,Bayern,298,688,4821,639350,37.0
2021-06-01 00:00:00+00:00,Bayern,868,731,5119,640218,39.0
2021-06-02 00:00:00+00:00,Bayern,682,660,4626,640900,35.0
2021-06-03 00:00:00+00:00,Bayern,404,560,3921,641304,30.0
2021-06-04 00:00:00+00:00,Bayern,313,500,3506,641617,27.0
2021-06-05 00:00:00+00:00,Bayern,454,485,3399,642071,26.0
2021-06-06 00:00:00+00:00,Bayern,224,463,3243,642295,25.0
2021-06-07 00:00:00+00:00,Bayern,283,461,3228,642578,25.0
2021-06-08 00:00:00+00:00,Bayern,750,444,3110,643328,24.0
2021-06-09 00:00:00+00:00,Bayern,552,425,2980,643880,23.0
2021-06-10 00:00:00+00:00,Bayern,418,427,2994,644298,23.0
2021-06-11 00:00:00+00:00,Bayern,289,424,2970,644587,23.0
2021-06-12 00:00:00+00:00,Bayern,250,395,2766,644837,21.0
2021-06-13 00:00:00+00:00,Bayern,116,379,2658,644953,20.0
2021-06-14 00:00:00+00:00,Bayern,128,357,2503,645081,19.0
2021-06-15 00:00:00+00:00,Bayern,370,303,2123,645451,16.0
2021-06-16 00:00:00+00:00,Bayern,279,264,1850,645730,14.0
2021-06-17 00:00:00+00:00,Bayern,198,232,1630,645928,12.0
2021-06-18 00:00:00+00:00,Bayern,181,217,1522,646109,12.0
2021-06-19 00:00:00+00:00,Bayern,133,200,1405,646242,11.0
2021-06-20 00:00:00+00:00,Bayern,84,196,1373,646326,10.0
2021-06-21 00:00:00+00:00,Bayern,86,190,1331,646412,10.0
2021-06-22 00:00:00+00:00,Bayern,229,170,1190,646641,9.0
2021-06-23 00:00:00+00:00,Bayern,165,153,1076,646806,8.0
2021-06-24 00:00:00+00:00,Bayern,148,146,1026,646954,8.0
2021-06-25 00:00:00+00:00,Bayern,119,137,964,647073,7.0
2021-06-26 00:00:00+00:00,Bayern,120,135,951,647193,7.0
2021-06-27 00:00:00+00:00,Bayern,61,132,928,647254,7.0
2021-06-28 00:00:00+00:00,Bayern,76,131,918,647330,7.0
2021-06-29 00:00:00+00:00,Bayern,175,123,864,647505,7.0
2021-06-30 00:00:00+00:00,Bayern,137,119,836,647642,6.0
2021-07-01 00:00:00+00:00,Bayern,114,114,802,647756,6.0
2021-07-02 00:00:00+00:00,Bayern,111,113,794,647867,6.0
2021-07-03 00:00:00+00:00,Bayern,86,108,760,647953,6.0
2021-07-04 00:00:00+00:00,Bayern,53,107,752,648006,6.0
2021-07-05 00:00:00+00:00,Bayern,85,108,761,648091,6.0
2021-07-06 00:00:00+00:00,Bayern,129,102,715,648220,5.0
2020-02-04 00:00:00+00:00,Niedersachsen,1,0,0,1,0.0
2020-03-01 00:00:00+00:00,Niedersachsen,1,0,0,2,0.0
2020-03-02 00:00:00+00:00,Niedersachsen,2,0,0,4,0.0
2020-03-03 00:00:00+00:00,Niedersachsen,6,0,0,10,0.0
2020-03-04 00:00:00+00:00,Niedersachsen,4,0,0,14,0.0
2020-03-05 00:00:00+00:00,Niedersachsen,6,0,0,20,0.0
2020-03-06 00:00:00+00:00,Niedersachsen,7,3,27,27,0.0
2020-03-07 00:00:00+00:00,Niedersachsen,8,4,34,35,0.0
2020-03-08 00:00:00+00:00,Niedersachsen,4,5,37,39,0.0
2020-03-09 00:00:00+00:00,Niedersachsen,14,7,49,53,1.0
2020-03-10 00:00:00+00:00,Niedersachsen,34,11,77,87,1.0
2020-03-11 00:00:00+00:00,Niedersachsen,62,19,135,149,2.0
2020-03-12 00:00:00+00:00,Niedersachsen,68,28,197,217,2.0
2020-03-13 00:00:00+00:00,Niedersachsen,91,40,281,308,4.0
2020-03-14 00:00:00+00:00,Niedersachsen,77,50,350,385,4.0
2020-03-15 00:00:00+00:00,Niedersachsen,68,59,414,453,5.0
2020-03-16 00:00:00+00:00,Niedersachsen,157,79,557,610,7.0
2020-03-17 00:00:00+00:00,Niedersachsen,176,99,699,786,9.0
2020-03-18 00:00:00+00:00,Niedersachsen,271,129,908,1057,11.0
2020-03-19 00:00:00+00:00,Niedersachsen,249,155,1089,1306,14.0
2020-03-20 00:00:00+00:00,Niedersachsen,266,180,1264,1572,16.0
2020-03-21 00:00:00+00:00,Niedersachsen,179,195,1366,1751,17.0
2020-03-22 00:00:00+00:00,Niedersachsen,108,200,1406,1859,18.0
2020-03-23 00:00:00+00:00,Niedersachsen,243,213,1492,2102,19.0
2020-03-24 00:00:00+00:00,Niedersachsen,294,230,1610,2396,20.0
2020-03-25 00:00:00+00:00,Niedersachsen,377,245,1716,2773,21.0
2020-03-26 00:00:00+00:00,Niedersachsen,371,262,1838,3144,23.0
2020-03-27 00:00:00+00:00,Niedersachsen,411,283,1983,3555,25.0
2020-03-28 00:00:00+00:00,Niedersachsen,347,307,2151,3902,27.0
2020-03-29 00:00:00+00:00,Niedersachsen,178,317,2221,4080,28.0
2020-03-30 00:00:00+00:00,Niedersachsen,311,327,2289,4391,29.0
2020-03-31 00:00:00+00:00,Niedersachsen,358,336,2353,4749,29.0
2020-04-01 00:00:00+00:00,Niedersachsen,368,334,2344,5117,29.0
2020-04-02 00:00:00+00:00,Niedersachsen,333,329,2306,5450,29.0
2020-04-03 00:00:00+00:00,Niedersachsen,388,326,2283,5838,29.0
2020-04-04 00:00:00+00:00,Niedersachsen,223,308,2159,6061,27.0
2020-04-05 00:00:00+00:00,Niedersachsen,142,303,2123,6203,27.0
2020-04-06 00:00:00+00:00,Niedersachsen,229,291,2041,6432,26.0
2020-04-07 00:00:00+00:00,Niedersachsen,372,293,2055,6804,26.0
2020-04-08 00:00:00+00:00,Niedersachsen,335,288,2022,7139,25.0
2020-04-09 00:00:00+00:00,Niedersachsen,314,286,2003,7453,25.0
2020-04-10 00:00:00+00:00,Niedersachsen,260,267,1875,7713,23.0
2020-04-11 00:00:00+00:00,Niedersachsen,128,254,1780,7841,22.0
2020-04-12 00:00:00+00:00,Niedersachsen,150,255,1788,7991,22.0
2020-04-13 00:00:00+00:00,Niedersachsen,80,234,1639,8071,21.0
2020-04-14 00:00:00+00:00,Niedersachsen,166,204,1433,8237,18.0
2020-04-15 00:00:00+00:00,Niedersachsen,226,189,1324,8463,17.0
2020-04-16 00:00:00+00:00,Niedersachsen,243,179,1253,8706,16.0
2020-04-17 00:00:00+00:00,Niedersachsen,197,170,1190,8903,15.0
2020-04-18 00:00:00+00:00,Niedersachsen,142,172,1204,9045,15.0
2020-04-19 00:00:00+00:00,Niedersachsen,96,164,1150,9141,14.0
2020-04-20 00:00:00+00:00,Niedersachsen,131,171,1201,9272,15.0
2020-04-21 00:00:00+00:00,Niedersachsen,163,171,1198,9435,15.0
2020-04-22 00:00:00+00:00,Niedersachsen,160,161,1132,9595,14.0
2020-04-23 00:00:00+00:00,Niedersachsen,140,147,1029,9735,13.0
2020-04-24 00:00:00+00:00,Niedersachsen,119,135,951,9854,12.0
2020-04-25 00:00:00+00:00,Niedersachsen,67,125,876,9921,11.0
2020-04-26 00:00:00+00:00,Niedersachsen,50,118,830,9971,10.0
2020-04-27 00:00:00+00:00,Niedersachsen,75,110,774,10046,10.0
2020-04-28 00:00:00+00:00,Niedersachsen,101,101,712,10147,9.0
2020-04-29 00:00:00+00:00,Niedersachsen,85,91,637,10232,8.0
2020-04-30 00:00:00+00:00,Niedersachsen,85,83,582,10317,7.0
2020-05-01 00:00:00+00:00,Niedersachsen,39,71,502,10356,6.0
2020-05-02 00:00:00+00:00,Niedersachsen,36,67,471,10392,6.0
2020-05-03 00:00:00+00:00,Niedersachsen,14,62,435,10406,5.0
2020-05-04 00:00:00+00:00,Niedersachsen,93,64,453,10499,6.0
2020-05-05 00:00:00+00:00,Niedersachsen,80,61,432,10579,5.0
2020-05-06 00:00:00+00:00,Niedersachsen,94,63,441,10673,6.0
2020-05-07 00:00:00+00:00,Niedersachsen,88,63,444,10761,6.0
2020-05-08 00:00:00+00:00,Niedersachsen,75,68,480,10836,6.0
2020-05-09 00:00:00+00:00,Niedersachsen,29,67,473,10865,6.0
2020-05-10 00:00:00+00:00,Niedersachsen,10,67,469,10875,6.0
2020-05-11 00:00:00+00:00,Niedersachsen,48,60,424,10923,5.0
2020-05-12 00:00:00+00:00,Niedersachsen,50,56,394,10973,5.0
2020-05-13 00:00:00+00:00,Niedersachsen,79,54,379,11052,5.0
2020-05-14 00:00:00+00:00,Niedersachsen,40,47,331,11092,4.0
2020-05-15 00:00:00+00:00,Niedersachsen,41,42,297,11133,4.0
2020-05-16 00:00:00+00:00,Niedersachsen,22,41,290,11155,4.0
2020-05-17 00:00:00+00:00,Niedersachsen,9,41,289,11164,4.0
2020-05-18 00:00:00+00:00,Niedersachsen,69,44,310,11233,4.0
2020-05-19 00:00:00+00:00,Niedersachsen,63,46,323,11296,4.0
2020-05-20 00:00:00+00:00,Niedersachsen,94,48,338,11390,4.0
2020-05-21 00:00:00+00:00,Niedersachsen,50,49,348,11440,4.0
2020-05-22 00:00:00+00:00,Niedersachsen,95,57,402,11535,5.0
2020-05-23 00:00:00+00:00,Niedersachsen,37,59,417,11572,5.0
2020-05-24 00:00:00+00:00,Niedersachsen,9,59,417,11581,5.0
2020-05-25 00:00:00+00:00,Niedersachsen,46,56,394,11627,5.0
2020-05-26 00:00:00+00:00,Niedersachsen,60,55,391,11687,5.0
2020-05-27 00:00:00+00:00,Niedersachsen,123,60,420,11810,5.0
2020-05-28 00:00:00+00:00,Niedersachsen,77,63,447,11887,6.0
2020-05-29 00:00:00+00:00,Niedersachsen,64,59,416,11951,5.0
2020-05-30 00:00:00+00:00,Niedersachsen,59,62,438,12010,5.0
2020-05-31 00:00:00+00:00,Niedersachsen,23,64,452,12033,6.0
2020-06-01 00:00:00+00:00,Niedersachsen,42,64,448,12075,6.0
2020-06-02 00:00:00+00:00,Niedersachsen,56,63,444,12131,6.0
2020-06-03 00:00:00+00:00,Niedersachsen,121,63,442,12252,6.0
2020-06-04 00:00:00+00:00,Niedersachsen,100,66,465,12352,6.0
2020-06-05 00:00:00+00:00,Niedersachsen,93,70,494,12445,6.0
2020-06-06 00:00:00+00:00,Niedersachsen,60,70,495,12505,6.0
2020-06-07 00:00:00+00:00,Niedersachsen,32,72,504,12537,6.0
2020-06-08 00:00:00+00:00,Niedersachsen,55,73,517,12592,6.0
2020-06-09 00:00:00+00:00,Niedersachsen,76,76,537,12668,7.0
2020-06-10 00:00:00+00:00,Niedersachsen,64,68,480,12732,6.0
2020-06-11 00:00:00+00:00,Niedersachsen,50,61,430,12782,5.0
2020-06-12 00:00:00+00:00,Niedersachsen,75,58,412,12857,5.0
2020-06-13 00:00:00+00:00,Niedersachsen,30,54,382,12887,5.0
2020-06-14 00:00:00+00:00,Niedersachsen,13,51,363,12900,5.0
2020-06-15 00:00:00+00:00,Niedersachsen,37,49,345,12937,4.0
2020-06-16 00:00:00+00:00,Niedersachsen,59,46,328,12996,4.0
2020-06-17 00:00:00+00:00,Niedersachsen,56,45,320,13052,4.0
2020-06-18 00:00:00+00:00,Niedersachsen,85,50,355,13137,4.0
2020-06-19 00:00:00+00:00,Niedersachsen,77,51,357,13214,4.0
2020-06-20 00:00:00+00:00,Niedersachsen,43,52,370,13257,5.0
2020-06-21 00:00:00+00:00,Niedersachsen,12,52,369,13269,5.0
2020-06-22 00:00:00+00:00,Niedersachsen,16,49,348,13285,4.0
2020-06-23 00:00:00+00:00,Niedersachsen,71,51,360,13356,5.0
2020-06-24 00:00:00+00:00,Niedersachsen,34,48,338,13390,4.0
2020-06-25 00:00:00+00:00,Niedersachsen,41,42,294,13431,4.0
2020-06-26 00:00:00+00:00,Niedersachsen,39,36,256,13470,3.0
2020-06-27 00:00:00+00:00,Niedersachsen,29,34,242,13499,3.0
2020-06-28 00:00:00+00:00,Niedersachsen,14,34,244,13513,3.0
2020-06-29 00:00:00+00:00,Niedersachsen,32,37,260,13545,3.0
2020-06-30 00:00:00+00:00,Niedersachsen,26,30,215,13571,3.0
2020-07-01 00:00:00+00:00,Niedersachsen,34,30,215,13605,3.0
2020-07-02 00:00:00+00:00,Niedersachsen,33,29,207,13638,3.0
2020-07-03 00:00:00+00:00,Niedersachsen,32,28,200,13670,3.0
2020-07-04 00:00:00+00:00,Niedersachsen,6,25,177,13676,2.0
2020-07-05 00:00:00+00:00,Niedersachsen,17,25,180,13693,2.0
2020-07-06 00:00:00+00:00,Niedersachsen,28,25,176,13721,2.0
2020-07-07 00:00:00+00:00,Niedersachsen,14,23,164,13735,2.0
2020-07-08 00:00:00+00:00,Niedersachsen,19,21,149,13754,2.0
2020-07-09 00:00:00+00:00,Niedersachsen,14,18,130,13768,2.0
2020-07-10 00:00:00+00:00,Niedersachsen,11,15,109,13779,1.0
2020-07-11 00:00:00+00:00,Niedersachsen,3,15,106,13782,1.0
2020-07-12 00:00:00+00:00,Niedersachsen,2,13,91,13784,1.0
2020-07-13 00:00:00+00:00,Niedersachsen,21,12,84,13805,1.0
2020-07-14 00:00:00+00:00,Niedersachsen,30,14,100,13835,1.0
2020-07-15 00:00:00+00:00,Niedersachsen,30,15,111,13865,1.0
2020-07-16 00:00:00+00:00,Niedersachsen,26,17,123,13891,2.0
2020-07-17 00:00:00+00:00,Niedersachsen,40,21,152,13931,2.0
2020-07-18 00:00:00+00:00,Niedersachsen,77,32,226,14008,3.0
2020-07-19 00:00:00+00:00,Niedersachsen,12,33,236,14020,3.0
2020-07-20 00:00:00+00:00,Niedersachsen,20,33,235,14040,3.0
2020-07-21 00:00:00+00:00,Niedersachsen,65,38,270,14105,3.0
2020-07-22 00:00:00+00:00,Niedersachsen,56,42,296,14161,4.0
2020-07-23 00:00:00+00:00,Niedersachsen,29,42,299,14190,4.0
2020-07-24 00:00:00+00:00,Niedersachsen,23,40,282,14213,4.0
2020-07-25 00:00:00+00:00,Niedersachsen,33,34,238,14246,3.0
2020-07-26 00:00:00+00:00,Niedersachsen,21,35,247,14267,3.0
2020-07-27 00:00:00+00:00,Niedersachsen,27,36,254,14294,3.0
2020-07-28 00:00:00+00:00,Niedersachsen,63,36,252,14357,3.0
2020-07-29 00:00:00+00:00,Niedersachsen,51,35,247,14408,3.0
2020-07-30 00:00:00+00:00,Niedersachsen,61,39,279,14469,3.0
2020-07-31 00:00:00+00:00,Niedersachsen,60,45,316,14529,4.0
2020-08-01 00:00:00+00:00,Niedersachsen,62,49,345,14591,4.0
2020-08-02 00:00:00+00:00,Niedersachsen,15,48,339,14606,4.0
2020-08-03 00:00:00+00:00,Niedersachsen,65,53,377,14671,5.0
2020-08-04 00:00:00+00:00,Niedersachsen,61,53,375,14732,5.0
2020-08-05 00:00:00+00:00,Niedersachsen,77,57,401,14809,5.0
2020-08-06 00:00:00+00:00,Niedersachsen,83,60,423,14892,5.0
2020-08-07 00:00:00+00:00,Niedersachsen,92,65,455,14984,6.0
2020-08-08 00:00:00+00:00,Niedersachsen,40,61,433,15024,5.0
2020-08-09 00:00:00+00:00,Niedersachsen,16,62,434,15040,5.0
2020-08-10 00:00:00+00:00,Niedersachsen,92,65,461,15132,6.0
2020-08-11 00:00:00+00:00,Niedersachsen,63,66,463,15195,6.0
2020-08-12 00:00:00+00:00,Niedersachsen,108,70,494,15303,6.0
2020-08-13 00:00:00+00:00,Niedersachsen,91,71,502,15394,6.0
2020-08-14 00:00:00+00:00,Niedersachsen,78,69,488,15472,6.0
2020-08-15 00:00:00+00:00,Niedersachsen,58,72,506,15530,6.0
2020-08-16 00:00:00+00:00,Niedersachsen,17,72,507,15547,6.0
2020-08-17 00:00:00+00:00,Niedersachsen,104,74,519,15651,6.0
2020-08-18 00:00:00+00:00,Niedersachsen,157,87,613,15808,8.0
2020-08-19 00:00:00+00:00,Niedersachsen,149,93,654,15957,8.0
2020-08-20 00:00:00+00:00,Niedersachsen,86,92,649,16043,8.0
2020-08-21 00:00:00+00:00,Niedersachsen,104,96,675,16147,8.0
2020-08-22 00:00:00+00:00,Niedersachsen,47,94,664,16194,8.0
2020-08-23 00:00:00+00:00,Niedersachsen,16,94,663,16210,8.0
2020-08-24 00:00:00+00:00,Niedersachsen,125,97,684,16335,9.0
2020-08-25 00:00:00+00:00,Niedersachsen,116,91,643,16451,8.0
2020-08-26 00:00:00+00:00,Niedersachsen,101,85,595,16552,7.0
2020-08-27 00:00:00+00:00,Niedersachsen,114,89,623,16666,8.0
2020-08-28 00:00:00+00:00,Niedersachsen,83,86,602,16749,8.0
2020-08-29 00:00:00+00:00,Niedersachsen,65,88,620,16814,8.0
2020-08-30 00:00:00+00:00,Niedersachsen,31,90,635,16845,8.0
2020-08-31 00:00:00+00:00,Niedersachsen,66,82,576,16911,7.0
2020-09-01 00:00:00+00:00,Niedersachsen,98,79,558,17009,7.0
2020-09-02 00:00:00+00:00,Niedersachsen,102,79,559,17111,7.0
2020-09-03 00:00:00+00:00,Niedersachsen,97,77,542,17208,7.0
2020-09-04 00:00:00+00:00,Niedersachsen,92,78,551,17300,7.0
2020-09-05 00:00:00+00:00,Niedersachsen,66,78,552,17366,7.0
2020-09-06 00:00:00+00:00,Niedersachsen,28,78,549,17394,7.0
2020-09-07 00:00:00+00:00,Niedersachsen,112,85,595,17506,7.0
2020-09-08 00:00:00+00:00,Niedersachsen,75,81,572,17581,7.0
2020-09-09 00:00:00+00:00,Niedersachsen,110,82,580,17691,7.0
2020-09-10 00:00:00+00:00,Niedersachsen,103,83,586,17794,7.0
2020-09-11 00:00:00+00:00,Niedersachsen,121,87,615,17915,8.0
2020-09-12 00:00:00+00:00,Niedersachsen,84,90,633,17999,8.0
2020-09-13 00:00:00+00:00,Niedersachsen,79,97,684,18078,9.0
2020-09-14 00:00:00+00:00,Niedersachsen,116,98,688,18194,9.0
2020-09-15 00:00:00+00:00,Niedersachsen,198,115,811,18392,10.0
2020-09-16 00:00:00+00:00,Niedersachsen,180,125,881,18572,11.0
2020-09-17 00:00:00+00:00,Niedersachsen,172,135,950,18744,12.0
2020-09-18 00:00:00+00:00,Niedersachsen,205,147,1034,18949,13.0
2020-09-19 00:00:00+00:00,Niedersachsen,100,150,1050,19049,13.0
2020-09-20 00:00:00+00:00,Niedersachsen,68,148,1039,19117,13.0
2020-09-21 00:00:00+00:00,Niedersachsen,92,145,1015,19209,13.0
2020-09-22 00:00:00+00:00,Niedersachsen,143,137,960,19352,12.0
2020-09-23 00:00:00+00:00,Niedersachsen,193,139,973,19545,12.0
2020-09-24 00:00:00+00:00,Niedersachsen,191,141,992,19736,12.0
2020-09-25 00:00:00+00:00,Niedersachsen,166,136,953,19902,12.0
2020-09-26 00:00:00+00:00,Niedersachsen,170,146,1023,20072,13.0
2020-09-27 00:00:00+00:00,Niedersachsen,56,144,1011,20128,13.0
2020-09-28 00:00:00+00:00,Niedersachsen,124,149,1043,20252,13.0
2020-09-29 00:00:00+00:00,Niedersachsen,141,148,1041,20393,13.0
2020-09-30 00:00:00+00:00,Niedersachsen,209,151,1057,20602,13.0
2020-10-01 00:00:00+00:00,Niedersachsen,267,161,1133,20869,14.0
2020-10-02 00:00:00+00:00,Niedersachsen,249,173,1216,21118,15.0
2020-10-03 00:00:00+00:00,Niedersachsen,213,179,1259,21331,16.0
2020-10-04 00:00:00+00:00,Niedersachsen,120,189,1323,21451,17.0
2020-10-05 00:00:00+00:00,Niedersachsen,122,188,1321,21573,17.0
2020-10-06 00:00:00+00:00,Niedersachsen,310,212,1490,21883,19.0
2020-10-07 00:00:00+00:00,Niedersachsen,387,238,1668,22270,21.0
2020-10-08 00:00:00+00:00,Niedersachsen,361,251,1762,22631,22.0
2020-10-09 00:00:00+00:00,Niedersachsen,339,264,1852,22970,23.0
2020-10-10 00:00:00+00:00,Niedersachsen,270,272,1909,23240,24.0
2020-10-11 00:00:00+00:00,Niedersachsen,204,284,1993,23444,25.0
2020-10-12 00:00:00+00:00,Niedersachsen,304,310,2175,23748,27.0
2020-10-13 00:00:00+00:00,Niedersachsen,448,330,2313,24196,29.0
2020-10-14 00:00:00+00:00,Niedersachsen,520,349,2446,24716,31.0
2020-10-15 00:00:00+00:00,Niedersachsen,555,377,2640,25271,33.0
2020-10-16 00:00:00+00:00,Niedersachsen,526,403,2827,25797,35.0
2020-10-17 00:00:00+00:00,Niedersachsen,418,425,2975,26215,37.0
2020-10-18 00:00:00+00:00,Niedersachsen,265,433,3036,26480,38.0
2020-10-19 00:00:00+00:00,Niedersachsen,360,441,3092,26840,39.0
2020-10-20 00:00:00+00:00,Niedersachsen,584,461,3228,27424,40.0
2020-10-21 00:00:00+00:00,Niedersachsen,854,508,3562,28278,45.0
2020-10-22 00:00:00+00:00,Niedersachsen,958,566,3965,29236,50.0
2020-10-23 00:00:00+00:00,Niedersachsen,770,601,4209,30006,53.0
2020-10-24 00:00:00+00:00,Niedersachsen,854,663,4645,30860,58.0
2020-10-25 00:00:00+00:00,Niedersachsen,401,683,4781,31261,60.0
2020-10-26 00:00:00+00:00,Niedersachsen,663,726,5084,31924,64.0
2020-10-27 00:00:00+00:00,Niedersachsen,1087,798,5587,33011,70.0
2020-10-28 00:00:00+00:00,Niedersachsen,1328,865,6061,34339,76.0
2020-10-29 00:00:00+00:00,Niedersachsen,1540,949,6643,35879,83.0
2020-10-30 00:00:00+00:00,Niedersachsen,1461,1047,7334,37340,92.0
2020-10-31 00:00:00+00:00,Niedersachsen,1007,1069,7487,38347,94.0
2020-11-01 00:00:00+00:00,Niedersachsen,717,1114,7803,39064,98.0
2020-11-02 00:00:00+00:00,Niedersachsen,1022,1166,8162,40086,102.0
2020-11-03 00:00:00+00:00,Niedersachsen,1302,1196,8377,41388,105.0
2020-11-04 00:00:00+00:00,Niedersachsen,1578,1232,8627,42966,108.0
2020-11-05 00:00:00+00:00,Niedersachsen,1434,1217,8521,44400,107.0
2020-11-06 00:00:00+00:00,Niedersachsen,1480,1220,8540,45880,107.0
2020-11-07 00:00:00+00:00,Niedersachsen,1290,1260,8823,47170,110.0
2020-11-08 00:00:00+00:00,Niedersachsen,662,1252,8768,47832,110.0
2020-11-09 00:00:00+00:00,Niedersachsen,905,1235,8651,48737,108.0
2020-11-10 00:00:00+00:00,Niedersachsen,1367,1245,8716,50104,109.0
2020-11-11 00:00:00+00:00,Niedersachsen,1636,1253,8774,51740,110.0
2020-11-12 00:00:00+00:00,Niedersachsen,1681,1288,9021,53421,113.0
2020-11-13 00:00:00+00:00,Niedersachsen,1421,1280,8962,54842,112.0
2020-11-14 00:00:00+00:00,Niedersachsen,1093,1252,8765,55935,110.0
2020-11-15 00:00:00+00:00,Niedersachsen,429,1218,8532,56364,107.0
2020-11-16 00:00:00+00:00,Niedersachsen,841,1209,8468,57205,106.0
2020-11-17 00:00:00+00:00,Niedersachsen,1327,1204,8428,58532,105.0
2020-11-18 00:00:00+00:00,Niedersachsen,1597,1198,8389,60129,105.0
2020-11-19 00:00:00+00:00,Niedersachsen,1673,1197,8381,61802,105.0
2020-11-20 00:00:00+00:00,Niedersachsen,1461,1203,8421,63263,105.0
2020-11-21 00:00:00+00:00,Niedersachsen,1035,1194,8363,64298,105.0
2020-11-22 00:00:00+00:00,Niedersachsen,522,1208,8456,64820,106.0
2020-11-23 00:00:00+00:00,Niedersachsen,733,1192,8348,65553,104.0
2020-11-24 00:00:00+00:00,Niedersachsen,1184,1172,8205,66737,103.0
2020-11-25 00:00:00+00:00,Niedersachsen,1413,1145,8021,68150,100.0
2020-11-26 00:00:00+00:00,Niedersachsen,1454,1114,7802,69604,98.0
2020-11-27 00:00:00+00:00,Niedersachsen,1019,1051,7360,70623,92.0
2020-11-28 00:00:00+00:00,Niedersachsen,855,1025,7180,71478,90.0
2020-11-29 00:00:00+00:00,Niedersachsen,373,1004,7031,71851,88.0
2020-11-30 00:00:00+00:00,Niedersachsen,588,983,6886,72439,86.0
2020-12-01 00:00:00+00:00,Niedersachsen,1012,959,6714,73451,84.0
2020-12-02 00:00:00+00:00,Niedersachsen,1349,950,6650,74800,83.0
2020-12-03 00:00:00+00:00,Niedersachsen,1378,939,6574,76178,82.0
2020-12-04 00:00:00+00:00,Niedersachsen,1077,947,6632,77255,83.0
2020-12-05 00:00:00+00:00,Niedersachsen,908,955,6685,78163,84.0
2020-12-06 00:00:00+00:00,Niedersachsen,280,941,6592,78443,82.0
2020-12-07 00:00:00+00:00,Niedersachsen,843,978,6847,79286,86.0
2020-12-08 00:00:00+00:00,Niedersachsen,1116,993,6951,80402,87.0
2020-12-09 00:00:00+00:00,Niedersachsen,1451,1007,7053,81853,88.0
2020-12-10 00:00:00+00:00,Niedersachsen,1694,1052,7369,83547,92.0
2020-12-11 00:00:00+00:00,Niedersachsen,1279,1081,7571,84826,95.0
2020-12-12 00:00:00+00:00,Niedersachsen,1165,1118,7828,85991,98.0
2020-12-13 00:00:00+00:00,Niedersachsen,421,1138,7969,86412,100.0
2020-12-14 00:00:00+00:00,Niedersachsen,904,1147,8030,87316,100.0
2020-12-15 00:00:00+00:00,Niedersachsen,1294,1172,8208,88610,103.0
2020-12-16 00:00:00+00:00,Niedersachsen,1957,1244,8714,90567,109.0
2020-12-17 00:00:00+00:00,Niedersachsen,1773,1256,8793,92340,110.0
2020-12-18 00:00:00+00:00,Niedersachsen,1530,1292,9044,93870,113.0
2020-12-19 00:00:00+00:00,Niedersachsen,1375,1322,9254,95245,116.0
2020-12-20 00:00:00+00:00,Niedersachsen,490,1331,9323,95735,117.0
2020-12-21 00:00:00+00:00,Niedersachsen,1227,1378,9646,96962,121.0
2020-12-22 00:00:00+00:00,Niedersachsen,1654,1429,10006,98616,125.0
2020-12-23 00:00:00+00:00,Niedersachsen,2052,1443,10101,100668,126.0
2020-12-24 00:00:00+00:00,Niedersachsen,1423,1393,9751,102091,122.0
2020-12-25 00:00:00+00:00,Niedersachsen,802,1289,9023,102893,113.0
2020-12-26 00:00:00+00:00,Niedersachsen,476,1160,8124,103369,102.0
2020-12-27 00:00:00+00:00,Niedersachsen,340,1139,7974,103709,100.0
2020-12-28 00:00:00+00:00,Niedersachsen,886,1090,7633,104595,95.0
2020-12-29 00:00:00+00:00,Niedersachsen,1661,1091,7640,106256,96.0
2020-12-30 00:00:00+00:00,Niedersachsen,2175,1109,7763,108431,97.0
2020-12-31 00:00:00+00:00,Niedersachsen,1450,1112,7790,109881,97.0
2021-01-01 00:00:00+00:00,Niedersachsen,522,1072,7510,110403,94.0
2021-01-02 00:00:00+00:00,Niedersachsen,579,1087,7613,110982,95.0
2021-01-03 00:00:00+00:00,Niedersachsen,389,1094,7662,111371,96.0
2021-01-04 00:00:00+00:00,Niedersachsen,825,1085,7601,112196,95.0
2021-01-05 00:00:00+00:00,Niedersachsen,1793,1104,7733,113989,97.0
2021-01-06 00:00:00+00:00,Niedersachsen,2274,1118,7832,116263,98.0
2021-01-07 00:00:00+00:00,Niedersachsen,1722,1157,8104,117985,101.0
2021-01-08 00:00:00+00:00,Niedersachsen,1486,1295,9068,119471,113.0
2021-01-09 00:00:00+00:00,Niedersachsen,1451,1420,9940,120922,124.0
2021-01-10 00:00:00+00:00,Niedersachsen,350,1414,9901,121272,124.0
2021-01-11 00:00:00+00:00,Niedersachsen,664,1391,9740,121936,122.0
2021-01-12 00:00:00+00:00,Niedersachsen,1531,1354,9478,123467,119.0
2021-01-13 00:00:00+00:00,Niedersachsen,1645,1264,8849,125112,111.0
2021-01-14 00:00:00+00:00,Niedersachsen,1450,1225,8577,126562,107.0
2021-01-15 00:00:00+00:00,Niedersachsen,1439,1218,8530,128001,107.0
2021-01-16 00:00:00+00:00,Niedersachsen,1098,1168,8177,129099,102.0
2021-01-17 00:00:00+00:00,Niedersachsen,523,1192,8350,129622,104.0
2021-01-18 00:00:00+00:00,Niedersachsen,669,1193,8355,130291,105.0
2021-01-19 00:00:00+00:00,Niedersachsen,1400,1174,8224,131691,103.0
2021-01-20 00:00:00+00:00,Niedersachsen,1389,1138,7968,133080,100.0
2021-01-21 00:00:00+00:00,Niedersachsen,1270,1112,7788,134350,97.0
2021-01-22 00:00:00+00:00,Niedersachsen,1252,1085,7601,135602,95.0
2021-01-23 00:00:00+00:00,Niedersachsen,896,1057,7399,136498,93.0
2021-01-24 00:00:00+00:00,Niedersachsen,323,1028,7199,136821,90.0
2021-01-25 00:00:00+00:00,Niedersachsen,418,992,6948,137239,87.0
2021-01-26 00:00:00+00:00,Niedersachsen,1171,959,6719,138410,84.0
2021-01-27 00:00:00+00:00,Niedersachsen,1442,967,6772,139852,85.0
2021-01-28 00:00:00+00:00,Niedersachsen,981,926,6483,140833,81.0
2021-01-29 00:00:00+00:00,Niedersachsen,1106,905,6337,141939,79.0
2021-01-30 00:00:00+00:00,Niedersachsen,940,911,6381,142879,80.0
2021-01-31 00:00:00+00:00,Niedersachsen,250,901,6308,143129,79.0
2021-02-01 00:00:00+00:00,Niedersachsen,430,902,6320,143559,79.0
2021-02-02 00:00:00+00:00,Niedersachsen,1065,887,6214,144624,78.0
2021-02-03 00:00:00+00:00,Niedersachsen,1163,847,5935,145787,74.0
2021-02-04 00:00:00+00:00,Niedersachsen,1029,854,5983,146816,75.0
2021-02-05 00:00:00+00:00,Niedersachsen,921,828,5798,147737,73.0
2021-02-06 00:00:00+00:00,Niedersachsen,861,817,5719,148598,72.0
2021-02-07 00:00:00+00:00,Niedersachsen,255,817,5724,148853,72.0
2021-02-08 00:00:00+00:00,Niedersachsen,268,794,5562,149121,70.0
2021-02-09 00:00:00+00:00,Niedersachsen,854,764,5351,149975,67.0
2021-02-10 00:00:00+00:00,Niedersachsen,1186,767,5374,151161,67.0
2021-02-11 00:00:00+00:00,Niedersachsen,1010,765,5355,152171,67.0
2021-02-12 00:00:00+00:00,Niedersachsen,1086,788,5520,153257,69.0
2021-02-13 00:00:00+00:00,Niedersachsen,533,741,5192,153790,65.0
2021-02-14 00:00:00+00:00,Niedersachsen,537,782,5474,154327,68.0
2021-02-15 00:00:00+00:00,Niedersachsen,418,803,5624,154745,70.0
2021-02-16 00:00:00+00:00,Niedersachsen,1070,834,5840,155815,73.0
2021-02-17 00:00:00+00:00,Niedersachsen,998,807,5652,156813,71.0
2021-02-18 00:00:00+00:00,Niedersachsen,870,787,5512,157683,69.0
2021-02-19 00:00:00+00:00,Niedersachsen,933,765,5359,158616,67.0
2021-02-20 00:00:00+00:00,Niedersachsen,962,826,5788,159578,72.0
2021-02-21 00:00:00+00:00,Niedersachsen,259,787,5510,159837,69.0
2021-02-22 00:00:00+00:00,Niedersachsen,386,782,5478,160223,69.0
2021-02-23 00:00:00+00:00,Niedersachsen,1031,777,5439,161254,68.0
2021-02-24 00:00:00+00:00,Niedersachsen,1152,799,5593,162406,70.0
2021-02-25 00:00:00+00:00,Niedersachsen,979,814,5702,163385,71.0
2021-02-26 00:00:00+00:00,Niedersachsen,1011,825,5780,164396,72.0
2021-02-27 00:00:00+00:00,Niedersachsen,700,788,5518,165096,69.0
2021-02-28 00:00:00+00:00,Niedersachsen,328,798,5587,165424,70.0
2021-03-01 00:00:00+00:00,Niedersachsen,323,789,5524,165747,69.0
2021-03-02 00:00:00+00:00,Niedersachsen,816,758,5309,166563,66.0
2021-03-03 00:00:00+00:00,Niedersachsen,1207,766,5364,167770,67.0
2021-03-04 00:00:00+00:00,Niedersachsen,873,751,5258,168643,66.0
2021-03-05 00:00:00+00:00,Niedersachsen,905,736,5152,169548,64.0
2021-03-06 00:00:00+00:00,Niedersachsen,931,769,5383,170479,67.0
2021-03-07 00:00:00+00:00,Niedersachsen,203,751,5258,170682,66.0
2021-03-08 00:00:00+00:00,Niedersachsen,427,766,5362,171109,67.0
2021-03-09 00:00:00+00:00,Niedersachsen,996,791,5542,172105,69.0
2021-03-10 00:00:00+00:00,Niedersachsen,1240,796,5575,173345,70.0
2021-03-11 00:00:00+00:00,Niedersachsen,1213,845,5915,174558,74.0
2021-03-12 00:00:00+00:00,Niedersachsen,1176,883,6186,175734,77.0
2021-03-13 00:00:00+00:00,Niedersachsen,1057,901,6312,176791,79.0
2021-03-14 00:00:00+00:00,Niedersachsen,327,919,6436,177118,81.0
2021-03-15 00:00:00+00:00,Niedersachsen,532,934,6541,177650,82.0
2021-03-16 00:00:00+00:00,Niedersachsen,1199,963,6744,178849,84.0
2021-03-17 00:00:00+00:00,Niedersachsen,1765,1038,7269,180614,91.0
2021-03-18 00:00:00+00:00,Niedersachsen,1503,1079,7559,182117,95.0
2021-03-19 00:00:00+00:00,Niedersachsen,1395,1111,7778,183512,97.0
2021-03-20 00:00:00+00:00,Niedersachsen,1124,1120,7845,184636,98.0
2021-03-21 00:00:00+00:00,Niedersachsen,354,1124,7872,184990,98.0
2021-03-22 00:00:00+00:00,Niedersachsen,689,1147,8029,185679,100.0
2021-03-23 00:00:00+00:00,Niedersachsen,1520,1192,8350,187199,104.0
2021-03-24 00:00:00+00:00,Niedersachsen,2011,1228,8596,189210,108.0
2021-03-25 00:00:00+00:00,Niedersachsen,2057,1307,9150,191267,114.0
2021-03-26 00:00:00+00:00,Niedersachsen,1697,1350,9452,192964,118.0
2021-03-27 00:00:00+00:00,Niedersachsen,1404,1390,9732,194368,122.0
2021-03-28 00:00:00+00:00,Niedersachsen,454,1404,9832,194822,123.0
2021-03-29 00:00:00+00:00,Niedersachsen,825,1424,9968,195647,125.0
2021-03-30 00:00:00+00:00,Niedersachsen,1468,1416,9916,197115,124.0
2021-03-31 00:00:00+00:00,Niedersachsen,1959,1409,9864,199074,123.0
2021-04-01 00:00:00+00:00,Niedersachsen,1753,1365,9560,200827,120.0
2021-04-02 00:00:00+00:00,Niedersachsen,1338,1314,9201,202165,115.0
2021-04-03 00:00:00+00:00,Niedersachsen,677,1210,8474,202842,106.0
2021-04-04 00:00:00+00:00,Niedersachsen,547,1223,8567,203389,107.0
2021-04-05 00:00:00+00:00,Niedersachsen,328,1152,8070,203717,101.0
2021-04-06 00:00:00+00:00,Niedersachsen,864,1066,7466,204581,93.0
2021-04-07 00:00:00+00:00,Niedersachsen,1729,1033,7236,206310,91.0
2021-04-08 00:00:00+00:00,Niedersachsen,2001,1069,7484,208311,94.0
2021-04-09 00:00:00+00:00,Niedersachsen,1885,1147,8031,210196,100.0
2021-04-10 00:00:00+00:00,Niedersachsen,1443,1256,8797,211639,110.0
2021-04-11 00:00:00+00:00,Niedersachsen,427,1239,8677,212066,109.0
2021-04-12 00:00:00+00:00,Niedersachsen,705,1293,9054,212771,113.0
2021-04-13 00:00:00+00:00,Niedersachsen,1917,1443,10107,214688,126.0
2021-04-14 00:00:00+00:00,Niedersachsen,2085,1494,10463,216773,131.0
2021-04-15 00:00:00+00:00,Niedersachsen,1932,1484,10394,218705,130.0
2021-04-16 00:00:00+00:00,Niedersachsen,1903,1487,10412,220608,130.0
2021-04-17 00:00:00+00:00,Niedersachsen,1332,1471,10301,221940,129.0
2021-04-18 00:00:00+00:00,Niedersachsen,436,1472,10310,222376,129.0
2021-04-19 00:00:00+00:00,Niedersachsen,696,1471,10301,223072,129.0
2021-04-20 00:00:00+00:00,Niedersachsen,1882,1466,10266,224954,128.0
2021-04-21 00:00:00+00:00,Niedersachsen,2292,1496,10473,227246,131.0
2021-04-22 00:00:00+00:00,Niedersachsen,1616,1451,10157,228862,127.0
2021-04-23 00:00:00+00:00,Niedersachsen,1648,1414,9902,230510,124.0
2021-04-24 00:00:00+00:00,Niedersachsen,1380,1421,9950,231890,124.0
2021-04-25 00:00:00+00:00,Niedersachsen,549,1437,10063,232439,126.0
2021-04-26 00:00:00+00:00,Niedersachsen,611,1425,9978,233050,125.0
2021-04-27 00:00:00+00:00,Niedersachsen,1651,1392,9747,234701,122.0
2021-04-28 00:00:00+00:00,Niedersachsen,1663,1302,9118,236364,114.0
2021-04-29 00:00:00+00:00,Niedersachsen,1518,1288,9020,237882,113.0
2021-04-30 00:00:00+00:00,Niedersachsen,1379,1250,8751,239261,109.0
2021-05-01 00:00:00+00:00,Niedersachsen,1094,1209,8465,240355,106.0
2021-05-02 00:00:00+00:00,Niedersachsen,316,1176,8232,240671,103.0
2021-05-03 00:00:00+00:00,Niedersachsen,493,1159,8114,241164,102.0
2021-05-04 00:00:00+00:00,Niedersachsen,1475,1134,7938,242639,99.0
2021-05-05 00:00:00+00:00,Niedersachsen,1532,1115,7807,244171,98.0
2021-05-06 00:00:00+00:00,Niedersachsen,1203,1070,7492,245374,94.0
2021-05-07 00:00:00+00:00,Niedersachsen,1175,1041,7288,246549,91.0
2021-05-08 00:00:00+00:00,Niedersachsen,829,1003,7023,247378,88.0
2021-05-09 00:00:00+00:00,Niedersachsen,246,993,6953,247624,87.0
2021-05-10 00:00:00+00:00,Niedersachsen,470,990,6930,248094,87.0
2021-05-11 00:00:00+00:00,Niedersachsen,1203,951,6658,249297,83.0
2021-05-12 00:00:00+00:00,Niedersachsen,1179,900,6305,250476,79.0
2021-05-13 00:00:00+00:00,Niedersachsen,666,824,5768,251142,72.0
2021-05-14 00:00:00+00:00,Niedersachsen,582,739,5175,251724,65.0
2021-05-15 00:00:00+00:00,Niedersachsen,534,697,4880,252258,61.0
2021-05-16 00:00:00+00:00,Niedersachsen,232,695,4866,252490,61.0
2021-05-17 00:00:00+00:00,Niedersachsen,275,667,4671,252765,58.0
2021-05-18 00:00:00+00:00,Niedersachsen,827,613,4295,253592,54.0
2021-05-19 00:00:00+00:00,Niedersachsen,902,574,4018,254494,50.0
2021-05-20 00:00:00+00:00,Niedersachsen,610,566,3962,255104,50.0
2021-05-21 00:00:00+00:00,Niedersachsen,540,560,3920,255644,49.0
2021-05-22 00:00:00+00:00,Niedersachsen,435,545,3821,256079,48.0
2021-05-23 00:00:00+00:00,Niedersachsen,93,526,3682,256172,46.0
2021-05-24 00:00:00+00:00,Niedersachsen,69,496,3476,256241,43.0
2021-05-25 00:00:00+00:00,Niedersachsen,200,407,2849,256441,36.0
2021-05-26 00:00:00+00:00,Niedersachsen,464,344,2411,256905,30.0
2021-05-27 00:00:00+00:00,Niedersachsen,429,318,2230,257334,28.0
2021-05-28 00:00:00+00:00,Niedersachsen,406,299,2096,257740,26.0
2021-05-29 00:00:00+00:00,Niedersachsen,242,271,1903,257982,24.0
2021-05-30 00:00:00+00:00,Niedersachsen,95,272,1905,258077,24.0
2021-05-31 00:00:00+00:00,Niedersachsen,187,289,2023,258264,25.0
2021-06-01 00:00:00+00:00,Niedersachsen,354,311,2177,258618,27.0
2021-06-02 00:00:00+00:00,Niedersachsen,303,288,2016,258921,25.0
2021-06-03 00:00:00+00:00,Niedersachsen,227,259,1814,259148,23.0
2021-06-04 00:00:00+00:00,Niedersachsen,144,221,1552,259292,19.0
2021-06-05 00:00:00+00:00,Niedersachsen,130,205,1440,259422,18.0
2021-06-06 00:00:00+00:00,Niedersachsen,40,197,1385,259462,17.0
2021-06-07 00:00:00+00:00,Niedersachsen,132,190,1330,259594,17.0
2021-06-08 00:00:00+00:00,Niedersachsen,188,166,1164,259782,15.0
2021-06-09 00:00:00+00:00,Niedersachsen,151,144,1012,259933,13.0
2021-06-10 00:00:00+00:00,Niedersachsen,122,129,907,260055,11.0
2021-06-11 00:00:00+00:00,Niedersachsen,101,123,864,260156,11.0
2021-06-12 00:00:00+00:00,Niedersachsen,77,115,811,260233,10.0
2021-06-13 00:00:00+00:00,Niedersachsen,19,112,790,260252,10.0
2021-06-14 00:00:00+00:00,Niedersachsen,50,101,708,260302,9.0
2021-06-15 00:00:00+00:00,Niedersachsen,101,88,621,260403,8.0
2021-06-16 00:00:00+00:00,Niedersachsen,67,76,537,260470,7.0
2021-06-17 00:00:00+00:00,Niedersachsen,64,68,479,260534,6.0
2021-06-18 00:00:00+00:00,Niedersachsen,63,63,441,260597,6.0
2021-06-19 00:00:00+00:00,Niedersachsen,44,58,408,260641,5.0
2021-06-20 00:00:00+00:00,Niedersachsen,6,56,395,260647,5.0
2021-06-21 00:00:00+00:00,Niedersachsen,34,54,379,260681,5.0
2021-06-22 00:00:00+00:00,Niedersachsen,65,49,343,260746,4.0
2021-06-23 00:00:00+00:00,Niedersachsen,55,47,331,260801,4.0
2021-06-24 00:00:00+00:00,Niedersachsen,28,42,295,260829,4.0
2021-06-25 00:00:00+00:00,Niedersachsen,37,38,269,260866,3.0
2021-06-26 00:00:00+00:00,Niedersachsen,30,36,255,260896,3.0
2021-06-27 00:00:00+00:00,Niedersachsen,7,36,256,260903,3.0
2021-06-28 00:00:00+00:00,Niedersachsen,35,36,257,260938,3.0
2021-06-29 00:00:00+00:00,Niedersachsen,62,36,254,261000,3.0
2021-06-30 00:00:00+00:00,Niedersachsen,64,37,263,261064,3.0
2021-07-01 00:00:00+00:00,Niedersachsen,44,39,279,261108,3.0
2021-07-02 00:00:00+00:00,Niedersachsen,70,44,312,261178,4.0
2021-07-03 00:00:00+00:00,Niedersachsen,31,44,313,261209,4.0
2021-07-04 00:00:00+00:00,Niedersachsen,12,45,318,261221,4.0
2021-07-05 00:00:00+00:00,Niedersachsen,34,45,317,261255,4.0
2021-07-06 00:00:00+00:00,Niedersachsen,74,47,329,261329,4.0
2020-02-17 00:00:00+00:00,Brandenburg,1,0,0,1,0.0
2020-02-18 00:00:00+00:00,Brandenburg,1,0,0,2,0.0
2020-02-25 00:00:00+00:00,Brandenburg,1,0,0,3,0.0
2020-03-01 00:00:00+00:00,Brandenburg,1,0,0,4,0.0
2020-03-05 00:00:00+00:00,Brandenburg,2,0,0,6,0.0
2020-03-08 00:00:00+00:00,Brandenburg,4,0,0,10,0.0
2020-03-09 00:00:00+00:00,Brandenburg,4,2,14,14,1.0
2020-03-10 00:00:00+00:00,Brandenburg,9,3,22,23,1.0
2020-03-11 00:00:00+00:00,Brandenburg,8,4,29,31,1.0
2020-03-12 00:00:00+00:00,Brandenburg,25,7,53,56,2.0
2020-03-13 00:00:00+00:00,Brandenburg,20,10,72,76,3.0
2020-03-14 00:00:00+00:00,Brandenburg,13,11,83,89,3.0
2020-03-15 00:00:00+00:00,Brandenburg,20,14,99,109,4.0
2020-03-16 00:00:00+00:00,Brandenburg,19,16,114,128,5.0
2020-03-17 00:00:00+00:00,Brandenburg,63,24,168,191,7.0
2020-03-18 00:00:00+00:00,Brandenburg,45,29,205,236,8.0
2020-03-19 00:00:00+00:00,Brandenburg,57,33,237,293,9.0
2020-03-20 00:00:00+00:00,Brandenburg,62,39,279,355,11.0
2020-03-21 00:00:00+00:00,Brandenburg,24,41,290,379,11.0
2020-03-22 00:00:00+00:00,Brandenburg,20,41,290,399,11.0
2020-03-23 00:00:00+00:00,Brandenburg,52,46,323,451,13.0
2020-03-24 00:00:00+00:00,Brandenburg,56,45,316,507,13.0
2020-03-25 00:00:00+00:00,Brandenburg,96,52,367,603,15.0
2020-03-26 00:00:00+00:00,Brandenburg,73,54,383,676,15.0
2020-03-27 00:00:00+00:00,Brandenburg,79,57,400,755,16.0
2020-03-28 00:00:00+00:00,Brandenburg,44,60,420,799,17.0
2020-03-29 00:00:00+00:00,Brandenburg,27,61,427,826,17.0
2020-03-30 00:00:00+00:00,Brandenburg,94,67,469,920,19.0
2020-03-31 00:00:00+00:00,Brandenburg,129,77,542,1049,21.0
2020-04-01 00:00:00+00:00,Brandenburg,69,73,515,1118,20.0
2020-04-02 00:00:00+00:00,Brandenburg,116,79,558,1234,22.0
2020-04-03 00:00:00+00:00,Brandenburg,137,88,616,1371,24.0
2020-04-04 00:00:00+00:00,Brandenburg,40,87,612,1411,24.0
2020-04-05 00:00:00+00:00,Brandenburg,27,87,612,1438,24.0
2020-04-06 00:00:00+00:00,Brandenburg,75,84,593,1513,24.0
2020-04-07 00:00:00+00:00,Brandenburg,107,81,571,1620,23.0
2020-04-08 00:00:00+00:00,Brandenburg,122,89,624,1742,25.0
2020-04-09 00:00:00+00:00,Brandenburg,115,89,623,1857,25.0
2020-04-10 00:00:00+00:00,Brandenburg,75,80,561,1932,22.0
2020-04-11 00:00:00+00:00,Brandenburg,49,81,570,1981,23.0
2020-04-12 00:00:00+00:00,Brandenburg,44,83,587,2025,23.0
2020-04-13 00:00:00+00:00,Brandenburg,12,74,524,2037,21.0
2020-04-14 00:00:00+00:00,Brandenburg,58,67,475,2095,19.0
2020-04-15 00:00:00+00:00,Brandenburg,70,60,423,2165,17.0
2020-04-16 00:00:00+00:00,Brandenburg,63,53,371,2228,15.0
2020-04-17 00:00:00+00:00,Brandenburg,112,58,408,2340,16.0
2020-04-18 00:00:00+00:00,Brandenburg,61,60,420,2401,17.0
2020-04-19 00:00:00+00:00,Brandenburg,29,57,405,2430,16.0
2020-04-20 00:00:00+00:00,Brandenburg,57,64,450,2487,18.0
2020-04-21 00:00:00+00:00,Brandenburg,63,65,455,2550,18.0
2020-04-22 00:00:00+00:00,Brandenburg,51,62,436,2601,17.0
2020-04-23 00:00:00+00:00,Brandenburg,40,59,413,2641,16.0
2020-04-24 00:00:00+00:00,Brandenburg,85,55,386,2726,15.0
2020-04-25 00:00:00+00:00,Brandenburg,24,49,349,2750,14.0
2020-04-26 00:00:00+00:00,Brandenburg,7,46,327,2757,13.0
2020-04-27 00:00:00+00:00,Brandenburg,39,44,309,2796,12.0
2020-04-28 00:00:00+00:00,Brandenburg,67,44,313,2863,12.0
2020-04-29 00:00:00+00:00,Brandenburg,37,42,299,2900,12.0
2020-04-30 00:00:00+00:00,Brandenburg,35,42,294,2935,12.0
2020-05-01 00:00:00+00:00,Brandenburg,33,34,242,2968,10.0
2020-05-02 00:00:00+00:00,Brandenburg,15,33,233,2983,9.0
2020-05-03 00:00:00+00:00,Brandenburg,6,33,232,2989,9.0
2020-05-04 00:00:00+00:00,Brandenburg,20,30,213,3009,8.0
2020-05-05 00:00:00+00:00,Brandenburg,43,27,189,3052,7.0
2020-05-06 00:00:00+00:00,Brandenburg,26,25,178,3078,7.0
2020-05-07 00:00:00+00:00,Brandenburg,11,22,154,3089,6.0
2020-05-08 00:00:00+00:00,Brandenburg,16,19,137,3105,5.0
2020-05-09 00:00:00+00:00,Brandenburg,5,18,127,3110,5.0
2020-05-10 00:00:00+00:00,Brandenburg,3,17,124,3113,5.0
2020-05-11 00:00:00+00:00,Brandenburg,9,16,113,3122,4.0
2020-05-12 00:00:00+00:00,Brandenburg,6,10,76,3128,3.0
2020-05-13 00:00:00+00:00,Brandenburg,10,8,60,3138,2.0
2020-05-14 00:00:00+00:00,Brandenburg,16,9,65,3154,3.0
2020-05-15 00:00:00+00:00,Brandenburg,7,8,56,3161,2.0
2020-05-16 00:00:00+00:00,Brandenburg,13,9,64,3174,3.0
2020-05-17 00:00:00+00:00,Brandenburg,1,8,62,3175,2.0
2020-05-18 00:00:00+00:00,Brandenburg,7,8,60,3182,2.0
2020-05-19 00:00:00+00:00,Brandenburg,4,8,58,3186,2.0
2020-05-20 00:00:00+00:00,Brandenburg,13,8,61,3199,2.0
2020-05-21 00:00:00+00:00,Brandenburg,3,6,48,3202,2.0
2020-05-22 00:00:00+00:00,Brandenburg,5,6,46,3207,2.0
2020-05-23 00:00:00+00:00,Brandenburg,5,5,38,3212,2.0
2020-05-24 00:00:00+00:00,Brandenburg,1,5,38,3213,2.0
2020-05-25 00:00:00+00:00,Brandenburg,7,5,38,3220,2.0
2020-05-26 00:00:00+00:00,Brandenburg,5,5,39,3225,2.0
2020-05-27 00:00:00+00:00,Brandenburg,6,4,32,3231,1.0
2020-05-28 00:00:00+00:00,Brandenburg,6,5,35,3237,1.0
2020-05-29 00:00:00+00:00,Brandenburg,3,4,33,3240,1.0
2020-05-30 00:00:00+00:00,Brandenburg,5,4,33,3245,1.0
2020-05-31 00:00:00+00:00,Brandenburg,1,4,33,3246,1.0
2020-06-02 00:00:00+00:00,Brandenburg,4,4,30,3250,1.0
2020-06-03 00:00:00+00:00,Brandenburg,5,4,30,3255,1.0
2020-06-04 00:00:00+00:00,Brandenburg,3,3,27,3258,1.0
2020-06-05 00:00:00+00:00,Brandenburg,3,3,24,3261,1.0
2020-06-06 00:00:00+00:00,Brandenburg,1,3,22,3262,1.0
2020-06-08 00:00:00+00:00,Brandenburg,2,2,19,3264,1.0
2020-06-09 00:00:00+00:00,Brandenburg,6,3,24,3270,1.0
2020-06-10 00:00:00+00:00,Brandenburg,5,3,25,3275,1.0
2020-06-11 00:00:00+00:00,Brandenburg,5,3,25,3280,1.0
2020-06-12 00:00:00+00:00,Brandenburg,8,4,30,3288,1.0
2020-06-13 00:00:00+00:00,Brandenburg,5,4,32,3293,1.0
2020-06-14 00:00:00+00:00,Brandenburg,1,4,32,3294,1.0
2020-06-15 00:00:00+00:00,Brandenburg,11,5,41,3305,2.0
2020-06-16 00:00:00+00:00,Brandenburg,12,6,47,3317,2.0
2020-06-17 00:00:00+00:00,Brandenburg,7,7,49,3324,2.0
2020-06-18 00:00:00+00:00,Brandenburg,12,8,56,3336,2.0
2020-06-19 00:00:00+00:00,Brandenburg,17,9,65,3353,3.0
2020-06-20 00:00:00+00:00,Brandenburg,14,10,74,3367,3.0
2020-06-22 00:00:00+00:00,Brandenburg,4,11,77,3371,3.0
2020-06-23 00:00:00+00:00,Brandenburg,13,11,79,3384,3.0
2020-06-24 00:00:00+00:00,Brandenburg,10,11,77,3394,3.0
2020-06-25 00:00:00+00:00,Brandenburg,4,10,74,3398,3.0
2020-06-26 00:00:00+00:00,Brandenburg,6,9,68,3404,3.0
2020-06-27 00:00:00+00:00,Brandenburg,1,7,52,3405,2.0
2020-06-28 00:00:00+00:00,Brandenburg,2,5,40,3407,2.0
2020-06-29 00:00:00+00:00,Brandenburg,5,5,41,3412,2.0
2020-06-30 00:00:00+00:00,Brandenburg,4,4,32,3416,1.0
2020-07-01 00:00:00+00:00,Brandenburg,9,4,31,3425,1.0
2020-07-02 00:00:00+00:00,Brandenburg,8,5,35,3433,1.0
2020-07-03 00:00:00+00:00,Brandenburg,10,5,39,3443,2.0
2020-07-04 00:00:00+00:00,Brandenburg,6,6,44,3449,2.0
2020-07-06 00:00:00+00:00,Brandenburg,5,6,47,3454,2.0
2020-07-07 00:00:00+00:00,Brandenburg,2,6,44,3456,2.0
2020-07-09 00:00:00+00:00,Brandenburg,5,6,45,3461,2.0
2020-07-10 00:00:00+00:00,Brandenburg,3,5,39,3464,2.0
2020-07-11 00:00:00+00:00,Brandenburg,4,5,35,3468,1.0
2020-07-12 00:00:00+00:00,Brandenburg,1,3,26,3469,1.0
2020-07-13 00:00:00+00:00,Brandenburg,2,3,22,3471,1.0
2020-07-14 00:00:00+00:00,Brandenburg,6,3,23,3477,1.0
2020-07-15 00:00:00+00:00,Brandenburg,4,3,25,3481,1.0
2020-07-16 00:00:00+00:00,Brandenburg,2,3,22,3483,1.0
2020-07-17 00:00:00+00:00,Brandenburg,5,3,24,3488,1.0
2020-07-18 00:00:00+00:00,Brandenburg,7,3,27,3495,1.0
2020-07-20 00:00:00+00:00,Brandenburg,27,7,53,3522,2.0
2020-07-21 00:00:00+00:00,Brandenburg,14,9,65,3536,3.0
2020-07-22 00:00:00+00:00,Brandenburg,11,10,70,3547,3.0
2020-07-23 00:00:00+00:00,Brandenburg,5,10,71,3552,3.0
2020-07-24 00:00:00+00:00,Brandenburg,1,10,70,3553,3.0
2020-07-25 00:00:00+00:00,Brandenburg,1,9,66,3554,3.0
2020-07-26 00:00:00+00:00,Brandenburg,2,8,61,3556,2.0
2020-07-27 00:00:00+00:00,Brandenburg,4,5,38,3560,2.0
2020-07-28 00:00:00+00:00,Brandenburg,9,4,33,3569,1.0
2020-07-29 00:00:00+00:00,Brandenburg,1,3,23,3570,1.0
2020-07-30 00:00:00+00:00,Brandenburg,10,4,28,3580,1.0
2020-07-31 00:00:00+00:00,Brandenburg,4,4,31,3584,1.0
2020-08-01 00:00:00+00:00,Brandenburg,2,4,32,3586,1.0
2020-08-02 00:00:00+00:00,Brandenburg,3,4,33,3589,1.0
2020-08-03 00:00:00+00:00,Brandenburg,5,4,34,3594,1.0
2020-08-04 00:00:00+00:00,Brandenburg,13,5,38,3607,2.0
2020-08-05 00:00:00+00:00,Brandenburg,8,6,45,3615,2.0
2020-08-06 00:00:00+00:00,Brandenburg,17,7,52,3632,2.0
2020-08-07 00:00:00+00:00,Brandenburg,19,9,67,3651,3.0
2020-08-08 00:00:00+00:00,Brandenburg,5,10,70,3656,3.0
2020-08-09 00:00:00+00:00,Brandenburg,1,9,68,3657,3.0
2020-08-10 00:00:00+00:00,Brandenburg,7,10,70,3664,3.0
2020-08-11 00:00:00+00:00,Brandenburg,8,9,65,3672,3.0
2020-08-12 00:00:00+00:00,Brandenburg,20,11,77,3692,3.0
2020-08-13 00:00:00+00:00,Brandenburg,10,10,70,3702,3.0
2020-08-14 00:00:00+00:00,Brandenburg,8,8,59,3710,2.0
2020-08-15 00:00:00+00:00,Brandenburg,5,8,59,3715,2.0
2020-08-16 00:00:00+00:00,Brandenburg,5,9,63,3720,2.0
2020-08-17 00:00:00+00:00,Brandenburg,16,10,72,3736,3.0
2020-08-18 00:00:00+00:00,Brandenburg,18,11,82,3754,3.0
2020-08-19 00:00:00+00:00,Brandenburg,19,11,81,3773,3.0
2020-08-20 00:00:00+00:00,Brandenburg,18,12,89,3791,4.0
2020-08-21 00:00:00+00:00,Brandenburg,15,13,96,3806,4.0
2020-08-22 00:00:00+00:00,Brandenburg,12,14,103,3818,4.0
2020-08-23 00:00:00+00:00,Brandenburg,4,14,102,3822,4.0
2020-08-24 00:00:00+00:00,Brandenburg,13,14,99,3835,4.0
2020-08-25 00:00:00+00:00,Brandenburg,18,14,99,3853,4.0
2020-08-26 00:00:00+00:00,Brandenburg,18,14,98,3871,4.0
2020-08-27 00:00:00+00:00,Brandenburg,13,13,93,3884,4.0
2020-08-28 00:00:00+00:00,Brandenburg,4,11,82,3888,3.0
2020-08-29 00:00:00+00:00,Brandenburg,1,10,71,3889,3.0
2020-08-30 00:00:00+00:00,Brandenburg,1,9,68,3890,3.0
2020-08-31 00:00:00+00:00,Brandenburg,5,8,60,3895,2.0
2020-09-01 00:00:00+00:00,Brandenburg,8,7,50,3903,2.0
2020-09-02 00:00:00+00:00,Brandenburg,10,6,42,3913,2.0
2020-09-03 00:00:00+00:00,Brandenburg,11,5,40,3924,2.0
2020-09-04 00:00:00+00:00,Brandenburg,22,8,58,3946,2.0
2020-09-05 00:00:00+00:00,Brandenburg,4,8,61,3950,2.0
2020-09-07 00:00:00+00:00,Brandenburg,13,10,73,3963,3.0
2020-09-08 00:00:00+00:00,Brandenburg,15,11,83,3978,3.0
2020-09-09 00:00:00+00:00,Brandenburg,7,11,82,3985,3.0
2020-09-10 00:00:00+00:00,Brandenburg,26,14,98,4011,4.0
2020-09-11 00:00:00+00:00,Brandenburg,8,13,95,4019,4.0
2020-09-12 00:00:00+00:00,Brandenburg,9,11,82,4028,3.0
2020-09-13 00:00:00+00:00,Brandenburg,3,11,81,4031,3.0
2020-09-14 00:00:00+00:00,Brandenburg,11,11,79,4042,3.0
2020-09-15 00:00:00+00:00,Brandenburg,16,11,80,4058,3.0
2020-09-16 00:00:00+00:00,Brandenburg,17,12,90,4075,4.0
2020-09-17 00:00:00+00:00,Brandenburg,11,10,75,4086,3.0
2020-09-18 00:00:00+00:00,Brandenburg,24,13,91,4110,4.0
2020-09-19 00:00:00+00:00,Brandenburg,7,12,89,4117,4.0
2020-09-20 00:00:00+00:00,Brandenburg,2,12,88,4119,3.0
2020-09-21 00:00:00+00:00,Brandenburg,17,13,94,4136,4.0
2020-09-22 00:00:00+00:00,Brandenburg,22,14,100,4158,4.0
2020-09-23 00:00:00+00:00,Brandenburg,26,15,109,4184,4.0
2020-09-24 00:00:00+00:00,Brandenburg,35,19,133,4219,5.0
2020-09-25 00:00:00+00:00,Brandenburg,26,19,135,4245,5.0
2020-09-26 00:00:00+00:00,Brandenburg,4,18,132,4249,5.0
2020-09-27 00:00:00+00:00,Brandenburg,3,19,133,4252,5.0
2020-09-28 00:00:00+00:00,Brandenburg,26,20,142,4278,6.0
2020-09-29 00:00:00+00:00,Brandenburg,40,22,160,4318,6.0
2020-09-30 00:00:00+00:00,Brandenburg,39,24,173,4357,7.0
2020-10-01 00:00:00+00:00,Brandenburg,44,26,182,4401,7.0
2020-10-02 00:00:00+00:00,Brandenburg,48,29,204,4449,8.0
2020-10-03 00:00:00+00:00,Brandenburg,29,32,229,4478,9.0
2020-10-04 00:00:00+00:00,Brandenburg,10,33,236,4488,9.0
2020-10-05 00:00:00+00:00,Brandenburg,35,35,245,4523,10.0
2020-10-06 00:00:00+00:00,Brandenburg,60,37,265,4583,11.0
2020-10-07 00:00:00+00:00,Brandenburg,61,41,287,4644,11.0
2020-10-08 00:00:00+00:00,Brandenburg,76,45,319,4720,13.0
2020-10-09 00:00:00+00:00,Brandenburg,114,55,385,4834,15.0
2020-10-10 00:00:00+00:00,Brandenburg,42,56,398,4876,16.0
2020-10-11 00:00:00+00:00,Brandenburg,24,58,412,4900,16.0
2020-10-12 00:00:00+00:00,Brandenburg,108,69,485,5008,19.0
2020-10-13 00:00:00+00:00,Brandenburg,115,77,540,5123,21.0
2020-10-14 00:00:00+00:00,Brandenburg,129,86,608,5252,24.0
2020-10-15 00:00:00+00:00,Brandenburg,124,93,656,5376,26.0
2020-10-16 00:00:00+00:00,Brandenburg,156,99,698,5532,28.0
2020-10-17 00:00:00+00:00,Brandenburg,73,104,729,5605,29.0
2020-10-18 00:00:00+00:00,Brandenburg,42,106,747,5647,30.0
2020-10-19 00:00:00+00:00,Brandenburg,122,108,761,5769,30.0
2020-10-20 00:00:00+00:00,Brandenburg,209,122,855,5978,34.0
2020-10-21 00:00:00+00:00,Brandenburg,198,132,924,6176,37.0
2020-10-22 00:00:00+00:00,Brandenburg,258,151,1058,6434,42.0
2020-10-23 00:00:00+00:00,Brandenburg,235,162,1137,6669,45.0
2020-10-24 00:00:00+00:00,Brandenburg,153,173,1217,6822,48.0
2020-10-25 00:00:00+00:00,Brandenburg,78,179,1253,6900,50.0
2020-10-26 00:00:00+00:00,Brandenburg,179,187,1310,7079,52.0
2020-10-27 00:00:00+00:00,Brandenburg,342,206,1443,7421,57.0
2020-10-28 00:00:00+00:00,Brandenburg,326,224,1571,7747,62.0
2020-10-29 00:00:00+00:00,Brandenburg,438,250,1751,8185,69.0
2020-10-30 00:00:00+00:00,Brandenburg,337,264,1853,8522,73.0
2020-10-31 00:00:00+00:00,Brandenburg,258,279,1958,8780,78.0
2020-11-01 00:00:00+00:00,Brandenburg,117,285,1997,8897,79.0
2020-11-02 00:00:00+00:00,Brandenburg,234,293,2052,9131,81.0
2020-11-03 00:00:00+00:00,Brandenburg,360,295,2070,9491,82.0
2020-11-04 00:00:00+00:00,Brandenburg,426,310,2170,9917,86.0
2020-11-05 00:00:00+00:00,Brandenburg,485,316,2217,10402,88.0
2020-11-06 00:00:00+00:00,Brandenburg,366,320,2246,10768,89.0
2020-11-07 00:00:00+00:00,Brandenburg,247,319,2235,11015,89.0
2020-11-08 00:00:00+00:00,Brandenburg,128,320,2246,11143,89.0
2020-11-09 00:00:00+00:00,Brandenburg,277,327,2289,11420,91.0
2020-11-10 00:00:00+00:00,Brandenburg,386,330,2315,11806,92.0
2020-11-11 00:00:00+00:00,Brandenburg,408,328,2297,12214,91.0
2020-11-12 00:00:00+00:00,Brandenburg,397,315,2209,12611,88.0
2020-11-13 00:00:00+00:00,Brandenburg,447,327,2290,13058,91.0
2020-11-14 00:00:00+00:00,Brandenburg,301,334,2344,13359,93.0
2020-11-15 00:00:00+00:00,Brandenburg,102,331,2318,13461,92.0
2020-11-16 00:00:00+00:00,Brandenburg,361,343,2402,13822,95.0
2020-11-17 00:00:00+00:00,Brandenburg,502,359,2518,14324,100.0
2020-11-18 00:00:00+00:00,Brandenburg,582,384,2692,14906,107.0
2020-11-19 00:00:00+00:00,Brandenburg,588,411,2883,15494,114.0
2020-11-20 00:00:00+00:00,Brandenburg,524,422,2960,16018,117.0
2020-11-21 00:00:00+00:00,Brandenburg,355,430,3014,16373,120.0
2020-11-22 00:00:00+00:00,Brandenburg,202,444,3114,16575,123.0
2020-11-23 00:00:00+00:00,Brandenburg,553,472,3306,17128,131.0
2020-11-24 00:00:00+00:00,Brandenburg,473,468,3277,17601,130.0
2020-11-25 00:00:00+00:00,Brandenburg,604,471,3299,18205,131.0
2020-11-26 00:00:00+00:00,Brandenburg,616,475,3327,18821,132.0
2020-11-27 00:00:00+00:00,Brandenburg,490,470,3293,19311,131.0
2020-11-28 00:00:00+00:00,Brandenburg,336,467,3274,19647,130.0
2020-11-29 00:00:00+00:00,Brandenburg,111,454,3183,19758,126.0
2020-11-30 00:00:00+00:00,Brandenburg,501,447,3131,20259,124.0
2020-12-01 00:00:00+00:00,Brandenburg,635,470,3293,20894,131.0
2020-12-02 00:00:00+00:00,Brandenburg,704,484,3393,21598,135.0
2020-12-03 00:00:00+00:00,Brandenburg,750,503,3527,22348,140.0
2020-12-04 00:00:00+00:00,Brandenburg,608,520,3645,22956,145.0
2020-12-05 00:00:00+00:00,Brandenburg,347,522,3656,23303,145.0
2020-12-06 00:00:00+00:00,Brandenburg,105,521,3650,23408,145.0
2020-12-07 00:00:00+00:00,Brandenburg,552,528,3701,23960,147.0
2020-12-08 00:00:00+00:00,Brandenburg,734,542,3800,24694,151.0
2020-12-09 00:00:00+00:00,Brandenburg,862,565,3958,25556,157.0
2020-12-10 00:00:00+00:00,Brandenburg,957,595,4165,26513,165.0
2020-12-11 00:00:00+00:00,Brandenburg,880,633,4437,27393,176.0
2020-12-12 00:00:00+00:00,Brandenburg,503,656,4593,27896,182.0
2020-12-13 00:00:00+00:00,Brandenburg,317,686,4805,28213,191.0
2020-12-14 00:00:00+00:00,Brandenburg,620,696,4873,28833,193.0
2020-12-15 00:00:00+00:00,Brandenburg,1021,737,5160,29854,205.0
2020-12-16 00:00:00+00:00,Brandenburg,1171,781,5469,31025,217.0
2020-12-17 00:00:00+00:00,Brandenburg,1210,817,5722,32235,227.0
2020-12-18 00:00:00+00:00,Brandenburg,1329,881,6171,33564,245.0
2020-12-19 00:00:00+00:00,Brandenburg,764,918,6432,34328,255.0
2020-12-20 00:00:00+00:00,Brandenburg,466,940,6581,34794,261.0
2020-12-21 00:00:00+00:00,Brandenburg,929,984,6890,35723,273.0
2020-12-22 00:00:00+00:00,Brandenburg,1276,1020,7145,36999,283.0
2020-12-23 00:00:00+00:00,Brandenburg,1158,1018,7132,38157,283.0
2020-12-24 00:00:00+00:00,Brandenburg,604,932,6526,38761,259.0
2020-12-25 00:00:00+00:00,Brandenburg,629,832,5826,39390,231.0
2020-12-26 00:00:00+00:00,Brandenburg,526,798,5588,39916,222.0
2020-12-27 00:00:00+00:00,Brandenburg,367,784,5489,40283,218.0
2020-12-28 00:00:00+00:00,Brandenburg,1031,798,5591,41314,222.0
2020-12-29 00:00:00+00:00,Brandenburg,1477,827,5792,42791,230.0
2020-12-30 00:00:00+00:00,Brandenburg,1563,885,6197,44354,246.0
2020-12-31 00:00:00+00:00,Brandenburg,787,911,6380,45141,253.0
2021-01-01 00:00:00+00:00,Brandenburg,431,883,6182,45572,245.0
2021-01-02 00:00:00+00:00,Brandenburg,292,849,5948,45864,236.0
2021-01-03 00:00:00+00:00,Brandenburg,234,830,5815,46098,231.0
2021-01-04 00:00:00+00:00,Brandenburg,932,816,5716,47030,227.0
2021-01-05 00:00:00+00:00,Brandenburg,1454,813,5693,48484,226.0
2021-01-06 00:00:00+00:00,Brandenburg,1578,815,5708,50062,226.0
2021-01-07 00:00:00+00:00,Brandenburg,1592,930,6513,51654,258.0
2021-01-08 00:00:00+00:00,Brandenburg,1232,1044,7314,52886,290.0
2021-01-09 00:00:00+00:00,Brandenburg,814,1119,7836,53700,311.0
2021-01-10 00:00:00+00:00,Brandenburg,468,1152,8070,54168,320.0
2021-01-11 00:00:00+00:00,Brandenburg,794,1133,7932,54962,315.0
2021-01-12 00:00:00+00:00,Brandenburg,1272,1107,7750,56234,307.0
2021-01-13 00:00:00+00:00,Brandenburg,1336,1072,7508,57570,298.0
2021-01-14 00:00:00+00:00,Brandenburg,1205,1017,7121,58775,282.0
2021-01-15 00:00:00+00:00,Brandenburg,1045,990,6934,59820,275.0
2021-01-16 00:00:00+00:00,Brandenburg,583,957,6703,60403,266.0
2021-01-17 00:00:00+00:00,Brandenburg,425,951,6660,60828,264.0
2021-01-18 00:00:00+00:00,Brandenburg,786,950,6652,61614,264.0
2021-01-19 00:00:00+00:00,Brandenburg,941,903,6321,62555,251.0
2021-01-20 00:00:00+00:00,Brandenburg,971,850,5956,63526,236.0
2021-01-21 00:00:00+00:00,Brandenburg,809,794,5560,64335,220.0
2021-01-22 00:00:00+00:00,Brandenburg,705,745,5220,65040,207.0
2021-01-23 00:00:00+00:00,Brandenburg,584,745,5221,65624,207.0
2021-01-24 00:00:00+00:00,Brandenburg,192,712,4988,65816,198.0
2021-01-25 00:00:00+00:00,Brandenburg,284,640,4486,66100,178.0
2021-01-26 00:00:00+00:00,Brandenburg,732,611,4277,66832,170.0
2021-01-27 00:00:00+00:00,Brandenburg,665,567,3971,67497,157.0
2021-01-28 00:00:00+00:00,Brandenburg,605,538,3767,68102,149.0
2021-01-29 00:00:00+00:00,Brandenburg,543,515,3605,68645,143.0
2021-01-30 00:00:00+00:00,Brandenburg,343,480,3364,68988,133.0
2021-01-31 00:00:00+00:00,Brandenburg,138,472,3310,69126,131.0
2021-02-01 00:00:00+00:00,Brandenburg,213,462,3239,69339,128.0
2021-02-02 00:00:00+00:00,Brandenburg,480,426,2987,69819,118.0
2021-02-03 00:00:00+00:00,Brandenburg,487,401,2809,70306,111.0
2021-02-04 00:00:00+00:00,Brandenburg,386,370,2590,70692,103.0
2021-02-05 00:00:00+00:00,Brandenburg,356,343,2403,71048,95.0
2021-02-06 00:00:00+00:00,Brandenburg,266,332,2326,71314,92.0
2021-02-07 00:00:00+00:00,Brandenburg,108,328,2296,71422,91.0
2021-02-08 00:00:00+00:00,Brandenburg,164,321,2247,71586,89.0
2021-02-09 00:00:00+00:00,Brandenburg,285,293,2052,71871,81.0
2021-02-10 00:00:00+00:00,Brandenburg,475,291,2040,72346,81.0
2021-02-11 00:00:00+00:00,Brandenburg,326,282,1980,72672,79.0
2021-02-12 00:00:00+00:00,Brandenburg,279,271,1903,72951,75.0
2021-02-13 00:00:00+00:00,Brandenburg,247,269,1884,73198,75.0
2021-02-14 00:00:00+00:00,Brandenburg,129,272,1905,73327,76.0
2021-02-15 00:00:00+00:00,Brandenburg,98,262,1839,73425,73.0
2021-02-16 00:00:00+00:00,Brandenburg,305,265,1859,73730,74.0
2021-02-17 00:00:00+00:00,Brandenburg,338,246,1722,74068,68.0
2021-02-18 00:00:00+00:00,Brandenburg,286,240,1682,74354,67.0
2021-02-19 00:00:00+00:00,Brandenburg,256,237,1659,74610,66.0
2021-02-20 00:00:00+00:00,Brandenburg,247,237,1659,74857,66.0
2021-02-21 00:00:00+00:00,Brandenburg,63,227,1593,74920,63.0
2021-02-22 00:00:00+00:00,Brandenburg,138,233,1633,75058,65.0
2021-02-23 00:00:00+00:00,Brandenburg,298,232,1626,75356,64.0
2021-02-24 00:00:00+00:00,Brandenburg,338,232,1626,75694,64.0
2021-02-25 00:00:00+00:00,Brandenburg,332,238,1672,76026,66.0
2021-02-26 00:00:00+00:00,Brandenburg,234,235,1650,76260,65.0
2021-02-27 00:00:00+00:00,Brandenburg,210,230,1613,76470,64.0
2021-02-28 00:00:00+00:00,Brandenburg,70,231,1620,76540,64.0
2021-03-01 00:00:00+00:00,Brandenburg,180,237,1662,76720,66.0
2021-03-02 00:00:00+00:00,Brandenburg,313,239,1677,77033,66.0
2021-03-03 00:00:00+00:00,Brandenburg,287,232,1626,77320,64.0
2021-03-04 00:00:00+00:00,Brandenburg,306,228,1600,77626,63.0
2021-03-05 00:00:00+00:00,Brandenburg,224,227,1590,77850,63.0
2021-03-06 00:00:00+00:00,Brandenburg,223,229,1603,78073,64.0
2021-03-07 00:00:00+00:00,Brandenburg,69,228,1602,78142,64.0
2021-03-08 00:00:00+00:00,Brandenburg,147,224,1569,78289,62.0
2021-03-09 00:00:00+00:00,Brandenburg,290,220,1546,78579,61.0
2021-03-10 00:00:00+00:00,Brandenburg,443,243,1702,79022,67.0
2021-03-11 00:00:00+00:00,Brandenburg,398,256,1794,79420,71.0
2021-03-12 00:00:00+00:00,Brandenburg,324,270,1894,79744,75.0
2021-03-13 00:00:00+00:00,Brandenburg,332,286,2003,80076,79.0
2021-03-14 00:00:00+00:00,Brandenburg,110,292,2044,80186,81.0
2021-03-15 00:00:00+00:00,Brandenburg,158,293,2055,80344,81.0
2021-03-16 00:00:00+00:00,Brandenburg,517,326,2282,80861,90.0
2021-03-17 00:00:00+00:00,Brandenburg,528,338,2367,81389,94.0
2021-03-18 00:00:00+00:00,Brandenburg,611,368,2580,82000,102.0
2021-03-19 00:00:00+00:00,Brandenburg,445,385,2701,82445,107.0
2021-03-20 00:00:00+00:00,Brandenburg,431,400,2800,82876,111.0
2021-03-21 00:00:00+00:00,Brandenburg,154,406,2844,83030,113.0
2021-03-22 00:00:00+00:00,Brandenburg,213,414,2899,83243,115.0
2021-03-23 00:00:00+00:00,Brandenburg,656,434,3038,83899,120.0
2021-03-24 00:00:00+00:00,Brandenburg,761,467,3271,84660,130.0
2021-03-25 00:00:00+00:00,Brandenburg,612,467,3272,85272,130.0
2021-03-26 00:00:00+00:00,Brandenburg,661,498,3488,85933,138.0
2021-03-27 00:00:00+00:00,Brandenburg,448,500,3505,86381,139.0
2021-03-28 00:00:00+00:00,Brandenburg,251,514,3602,86632,143.0
2021-03-29 00:00:00+00:00,Brandenburg,309,528,3698,86941,147.0
2021-03-30 00:00:00+00:00,Brandenburg,621,523,3663,87562,145.0
2021-03-31 00:00:00+00:00,Brandenburg,853,536,3755,88415,149.0
2021-04-01 00:00:00+00:00,Brandenburg,726,552,3869,89141,153.0
2021-04-02 00:00:00+00:00,Brandenburg,483,527,3691,89624,146.0
2021-04-03 00:00:00+00:00,Brandenburg,235,496,3478,89859,138.0
2021-04-04 00:00:00+00:00,Brandenburg,175,486,3402,90034,135.0
2021-04-05 00:00:00+00:00,Brandenburg,106,457,3199,90140,127.0
2021-04-06 00:00:00+00:00,Brandenburg,185,394,2763,90325,110.0
2021-04-07 00:00:00+00:00,Brandenburg,588,356,2498,90913,99.0
2021-04-08 00:00:00+00:00,Brandenburg,864,376,2636,91777,105.0
2021-04-09 00:00:00+00:00,Brandenburg,656,401,2809,92433,111.0
2021-04-10 00:00:00+00:00,Brandenburg,438,430,3012,92871,119.0
2021-04-11 00:00:00+00:00,Brandenburg,302,448,3139,93173,124.0
2021-04-12 00:00:00+00:00,Brandenburg,211,463,3244,93384,129.0
2021-04-13 00:00:00+00:00,Brandenburg,611,524,3670,93995,146.0
2021-04-14 00:00:00+00:00,Brandenburg,853,562,3935,94848,156.0
2021-04-15 00:00:00+00:00,Brandenburg,641,530,3712,95489,147.0
2021-04-16 00:00:00+00:00,Brandenburg,568,517,3624,96057,144.0
2021-04-17 00:00:00+00:00,Brandenburg,442,518,3628,96499,144.0
2021-04-18 00:00:00+00:00,Brandenburg,234,508,3560,96733,141.0
2021-04-19 00:00:00+00:00,Brandenburg,262,515,3611,96995,143.0
2021-04-20 00:00:00+00:00,Brandenburg,529,504,3529,97524,140.0
2021-04-21 00:00:00+00:00,Brandenburg,817,499,3493,98341,139.0
2021-04-22 00:00:00+00:00,Brandenburg,508,480,3360,98849,133.0
2021-04-23 00:00:00+00:00,Brandenburg,501,470,3293,99350,131.0
2021-04-24 00:00:00+00:00,Brandenburg,382,461,3233,99732,128.0
2021-04-25 00:00:00+00:00,Brandenburg,212,458,3211,99944,127.0
2021-04-26 00:00:00+00:00,Brandenburg,154,443,3103,100098,123.0
2021-04-27 00:00:00+00:00,Brandenburg,515,441,3089,100613,122.0
2021-04-28 00:00:00+00:00,Brandenburg,619,413,2891,101232,115.0
2021-04-29 00:00:00+00:00,Brandenburg,491,410,2874,101723,114.0
2021-04-30 00:00:00+00:00,Brandenburg,394,395,2767,102117,110.0
2021-05-01 00:00:00+00:00,Brandenburg,315,385,2700,102432,107.0
2021-05-02 00:00:00+00:00,Brandenburg,169,379,2657,102601,105.0
2021-05-03 00:00:00+00:00,Brandenburg,127,375,2630,102728,104.0
2021-05-04 00:00:00+00:00,Brandenburg,458,367,2573,103186,102.0
2021-05-05 00:00:00+00:00,Brandenburg,533,355,2487,103719,99.0
2021-05-06 00:00:00+00:00,Brandenburg,367,337,2363,104086,94.0
2021-05-07 00:00:00+00:00,Brandenburg,331,328,2300,104417,91.0
2021-05-08 00:00:00+00:00,Brandenburg,252,319,2237,104669,89.0
2021-05-09 00:00:00+00:00,Brandenburg,137,315,2205,104806,87.0
2021-05-10 00:00:00+00:00,Brandenburg,84,308,2162,104890,86.0
2021-05-11 00:00:00+00:00,Brandenburg,360,294,2064,105250,82.0
2021-05-12 00:00:00+00:00,Brandenburg,403,276,1934,105653,77.0
2021-05-13 00:00:00+00:00,Brandenburg,245,258,1812,105898,72.0
2021-05-14 00:00:00+00:00,Brandenburg,161,234,1642,106059,65.0
2021-05-15 00:00:00+00:00,Brandenburg,176,223,1566,106235,62.0
2021-05-16 00:00:00+00:00,Brandenburg,86,216,1515,106321,60.0
2021-05-17 00:00:00+00:00,Brandenburg,96,218,1527,106417,61.0
2021-05-18 00:00:00+00:00,Brandenburg,249,202,1416,106666,56.0
2021-05-19 00:00:00+00:00,Brandenburg,289,186,1302,106955,52.0
2021-05-20 00:00:00+00:00,Brandenburg,192,178,1249,107147,50.0
2021-05-21 00:00:00+00:00,Brandenburg,173,180,1261,107320,50.0
2021-05-22 00:00:00+00:00,Brandenburg,125,172,1210,107445,48.0
2021-05-23 00:00:00+00:00,Brandenburg,52,168,1176,107497,47.0
2021-05-24 00:00:00+00:00,Brandenburg,22,157,1102,107519,44.0
2021-05-25 00:00:00+00:00,Brandenburg,52,129,905,107571,36.0
2021-05-26 00:00:00+00:00,Brandenburg,116,104,732,107687,29.0
2021-05-27 00:00:00+00:00,Brandenburg,164,100,704,107851,28.0
2021-05-28 00:00:00+00:00,Brandenburg,72,86,603,107923,24.0
2021-05-29 00:00:00+00:00,Brandenburg,46,74,524,107969,21.0
2021-05-30 00:00:00+00:00,Brandenburg,31,71,503,108000,20.0
2021-05-31 00:00:00+00:00,Brandenburg,19,71,500,108019,20.0
2021-06-01 00:00:00+00:00,Brandenburg,86,76,534,108105,21.0
2021-06-02 00:00:00+00:00,Brandenburg,79,71,497,108184,20.0
2021-06-03 00:00:00+00:00,Brandenburg,59,56,392,108243,16.0
2021-06-04 00:00:00+00:00,Brandenburg,40,51,360,108283,14.0
2021-06-05 00:00:00+00:00,Brandenburg,25,48,339,108308,13.0
2021-06-06 00:00:00+00:00,Brandenburg,25,47,333,108333,13.0
2021-06-07 00:00:00+00:00,Brandenburg,20,47,334,108353,13.0
2021-06-08 00:00:00+00:00,Brandenburg,36,40,284,108389,11.0
2021-06-09 00:00:00+00:00,Brandenburg,34,34,239,108423,9.0
2021-06-10 00:00:00+00:00,Brandenburg,21,28,201,108444,8.0
2021-06-11 00:00:00+00:00,Brandenburg,20,25,181,108464,7.0
2021-06-12 00:00:00+00:00,Brandenburg,30,26,186,108494,7.0
2021-06-13 00:00:00+00:00,Brandenburg,13,24,174,108507,7.0
2021-06-14 00:00:00+00:00,Brandenburg,8,23,162,108515,6.0
2021-06-15 00:00:00+00:00,Brandenburg,31,22,157,108546,6.0
2021-06-16 00:00:00+00:00,Brandenburg,16,19,139,108562,6.0
2021-06-17 00:00:00+00:00,Brandenburg,7,17,125,108569,5.0
2021-06-18 00:00:00+00:00,Brandenburg,15,17,120,108584,5.0
2021-06-19 00:00:00+00:00,Brandenburg,12,14,102,108596,4.0
2021-06-20 00:00:00+00:00,Brandenburg,3,13,92,108599,4.0
2021-06-21 00:00:00+00:00,Brandenburg,2,12,86,108601,3.0
2021-06-22 00:00:00+00:00,Brandenburg,9,9,64,108610,3.0
2021-06-23 00:00:00+00:00,Brandenburg,10,8,58,108620,2.0
2021-06-24 00:00:00+00:00,Brandenburg,19,10,70,108639,3.0
2021-06-25 00:00:00+00:00,Brandenburg,16,10,71,108655,3.0
2021-06-26 00:00:00+00:00,Brandenburg,6,9,65,108661,3.0
2021-06-27 00:00:00+00:00,Brandenburg,1,9,63,108662,2.0
2021-06-28 00:00:00+00:00,Brandenburg,4,9,65,108666,3.0
2021-06-29 00:00:00+00:00,Brandenburg,13,9,69,108679,3.0
2021-06-30 00:00:00+00:00,Brandenburg,10,9,69,108689,3.0
2021-07-01 00:00:00+00:00,Brandenburg,16,9,66,108705,3.0
2021-07-02 00:00:00+00:00,Brandenburg,11,8,61,108716,2.0
2021-07-03 00:00:00+00:00,Brandenburg,3,8,58,108719,2.0
2021-07-05 00:00:00+00:00,Brandenburg,7,9,64,108726,3.0
2021-07-06 00:00:00+00:00,Brandenburg,17,11,77,108743,3.0
2020-02-28 00:00:00+00:00,Hessen,1,0,0,1,0.0
2020-03-01 00:00:00+00:00,Hessen,3,0,0,4,0.0
2020-03-02 00:00:00+00:00,Hessen,4,0,0,8,0.0
2020-03-03 00:00:00+00:00,Hessen,4,0,0,12,0.0
2020-03-04 00:00:00+00:00,Hessen,2,0,0,14,0.0
2020-03-05 00:00:00+00:00,Hessen,6,0,0,20,0.0
2020-03-06 00:00:00+00:00,Hessen,1,3,21,21,0.0
2020-03-07 00:00:00+00:00,Hessen,4,3,24,25,0.0
2020-03-09 00:00:00+00:00,Hessen,20,5,41,45,1.0
2020-03-10 00:00:00+00:00,Hessen,16,7,53,61,1.0
2020-03-11 00:00:00+00:00,Hessen,37,12,86,98,1.0
2020-03-12 00:00:00+00:00,Hessen,38,17,122,136,2.0
2020-03-13 00:00:00+00:00,Hessen,79,27,195,215,3.0
2020-03-14 00:00:00+00:00,Hessen,83,39,277,298,4.0
2020-03-15 00:00:00+00:00,Hessen,24,42,297,322,5.0
2020-03-16 00:00:00+00:00,Hessen,125,57,402,447,6.0
2020-03-17 00:00:00+00:00,Hessen,168,79,554,615,9.0
2020-03-18 00:00:00+00:00,Hessen,224,105,741,839,12.0
2020-03-19 00:00:00+00:00,Hessen,203,129,906,1042,14.0
2020-03-20 00:00:00+00:00,Hessen,211,148,1038,1253,17.0
2020-03-21 00:00:00+00:00,Hessen,134,155,1089,1387,17.0
2020-03-22 00:00:00+00:00,Hessen,58,160,1123,1445,18.0
2020-03-23 00:00:00+00:00,Hessen,275,181,1273,1720,20.0
2020-03-24 00:00:00+00:00,Hessen,234,191,1339,1954,21.0
2020-03-25 00:00:00+00:00,Hessen,248,194,1363,2202,22.0
2020-03-26 00:00:00+00:00,Hessen,302,208,1462,2504,23.0
2020-03-27 00:00:00+00:00,Hessen,308,222,1559,2812,25.0
2020-03-28 00:00:00+00:00,Hessen,186,230,1611,2998,26.0
2020-03-29 00:00:00+00:00,Hessen,140,241,1693,3138,27.0
2020-03-30 00:00:00+00:00,Hessen,182,228,1600,3320,25.0
2020-03-31 00:00:00+00:00,Hessen,254,231,1620,3574,26.0
2020-04-01 00:00:00+00:00,Hessen,329,243,1701,3903,27.0
2020-04-02 00:00:00+00:00,Hessen,267,238,1666,4170,26.0
2020-04-03 00:00:00+00:00,Hessen,250,229,1608,4420,26.0
2020-04-04 00:00:00+00:00,Hessen,223,235,1645,4643,26.0
2020-04-05 00:00:00+00:00,Hessen,91,228,1596,4734,25.0
2020-04-06 00:00:00+00:00,Hessen,139,221,1553,4873,25.0
2020-04-07 00:00:00+00:00,Hessen,255,222,1554,5128,25.0
2020-04-08 00:00:00+00:00,Hessen,304,218,1529,5432,24.0
2020-04-09 00:00:00+00:00,Hessen,291,221,1553,5723,25.0
2020-04-10 00:00:00+00:00,Hessen,154,208,1457,5877,23.0
2020-04-11 00:00:00+00:00,Hessen,150,197,1384,6027,22.0
2020-04-12 00:00:00+00:00,Hessen,98,198,1391,6125,22.0
2020-04-13 00:00:00+00:00,Hessen,77,189,1329,6202,21.0
2020-04-14 00:00:00+00:00,Hessen,160,176,1234,6362,20.0
2020-04-15 00:00:00+00:00,Hessen,227,165,1157,6589,18.0
2020-04-16 00:00:00+00:00,Hessen,208,153,1074,6797,17.0
2020-04-17 00:00:00+00:00,Hessen,190,158,1110,6987,18.0
2020-04-18 00:00:00+00:00,Hessen,129,155,1089,7116,17.0
2020-04-19 00:00:00+00:00,Hessen,73,152,1064,7189,17.0
2020-04-20 00:00:00+00:00,Hessen,79,152,1066,7268,17.0
2020-04-21 00:00:00+00:00,Hessen,169,153,1075,7437,17.0
2020-04-22 00:00:00+00:00,Hessen,177,146,1025,7614,16.0
2020-04-23 00:00:00+00:00,Hessen,125,134,942,7739,15.0
2020-04-24 00:00:00+00:00,Hessen,103,122,855,7842,14.0
2020-04-25 00:00:00+00:00,Hessen,89,116,815,7931,13.0
2020-04-26 00:00:00+00:00,Hessen,24,109,766,7955,12.0
2020-04-27 00:00:00+00:00,Hessen,68,107,755,8023,12.0
2020-04-28 00:00:00+00:00,Hessen,139,103,725,8162,12.0
2020-04-29 00:00:00+00:00,Hessen,121,95,669,8283,11.0
2020-04-30 00:00:00+00:00,Hessen,104,92,648,8387,10.0
2020-05-01 00:00:00+00:00,Hessen,79,89,624,8466,10.0
2020-05-02 00:00:00+00:00,Hessen,40,82,575,8506,9.0
2020-05-03 00:00:00+00:00,Hessen,26,82,577,8532,9.0
2020-05-04 00:00:00+00:00,Hessen,28,76,537,8560,9.0
2020-05-05 00:00:00+00:00,Hessen,89,69,487,8649,8.0
2020-05-06 00:00:00+00:00,Hessen,105,67,471,8754,7.0
2020-05-07 00:00:00+00:00,Hessen,83,64,450,8837,7.0
2020-05-08 00:00:00+00:00,Hessen,86,65,457,8923,7.0
2020-05-09 00:00:00+00:00,Hessen,47,66,464,8970,7.0
2020-05-10 00:00:00+00:00,Hessen,15,64,453,8985,7.0
2020-05-11 00:00:00+00:00,Hessen,32,65,457,9017,7.0
2020-05-12 00:00:00+00:00,Hessen,82,64,450,9099,7.0
2020-05-13 00:00:00+00:00,Hessen,70,59,415,9169,7.0
2020-05-14 00:00:00+00:00,Hessen,46,54,378,9215,6.0
2020-05-15 00:00:00+00:00,Hessen,69,51,361,9284,6.0
2020-05-16 00:00:00+00:00,Hessen,34,49,348,9318,6.0
2020-05-17 00:00:00+00:00,Hessen,74,58,407,9392,6.0
2020-05-18 00:00:00+00:00,Hessen,61,62,436,9453,7.0
2020-05-19 00:00:00+00:00,Hessen,74,61,428,9527,7.0
2020-05-20 00:00:00+00:00,Hessen,102,65,460,9629,7.0
2020-05-21 00:00:00+00:00,Hessen,30,63,444,9659,7.0
2020-05-22 00:00:00+00:00,Hessen,49,60,424,9708,7.0
2020-05-23 00:00:00+00:00,Hessen,51,63,441,9759,7.0
2020-05-24 00:00:00+00:00,Hessen,14,54,381,9773,6.0
2020-05-25 00:00:00+00:00,Hessen,30,50,350,9803,6.0
2020-05-26 00:00:00+00:00,Hessen,76,50,352,9879,6.0
2020-05-27 00:00:00+00:00,Hessen,46,42,296,9925,5.0
2020-05-28 00:00:00+00:00,Hessen,58,46,324,9983,5.0
2020-05-29 00:00:00+00:00,Hessen,38,44,313,10021,5.0
2020-05-30 00:00:00+00:00,Hessen,34,42,296,10055,5.0
2020-05-31 00:00:00+00:00,Hessen,11,41,293,10066,5.0
2020-06-01 00:00:00+00:00,Hessen,2,37,265,10068,4.0
2020-06-02 00:00:00+00:00,Hessen,26,30,215,10094,3.0
2020-06-03 00:00:00+00:00,Hessen,35,29,204,10129,3.0
2020-06-04 00:00:00+00:00,Hessen,29,25,175,10158,3.0
2020-06-05 00:00:00+00:00,Hessen,24,23,161,10182,3.0
2020-06-06 00:00:00+00:00,Hessen,19,20,146,10201,2.0
2020-06-07 00:00:00+00:00,Hessen,8,20,143,10209,2.0
2020-06-08 00:00:00+00:00,Hessen,36,25,177,10245,3.0
2020-06-09 00:00:00+00:00,Hessen,17,24,168,10262,3.0
2020-06-10 00:00:00+00:00,Hessen,37,24,170,10299,3.0
2020-06-11 00:00:00+00:00,Hessen,9,21,150,10308,2.0
2020-06-12 00:00:00+00:00,Hessen,25,21,151,10333,2.0
2020-06-13 00:00:00+00:00,Hessen,19,21,151,10352,2.0
2020-06-14 00:00:00+00:00,Hessen,6,21,149,10358,2.0
2020-06-15 00:00:00+00:00,Hessen,8,17,121,10366,2.0
2020-06-16 00:00:00+00:00,Hessen,40,20,144,10406,2.0
2020-06-17 00:00:00+00:00,Hessen,57,23,164,10463,3.0
2020-06-18 00:00:00+00:00,Hessen,48,29,203,10511,3.0
2020-06-19 00:00:00+00:00,Hessen,58,33,236,10569,4.0
2020-06-20 00:00:00+00:00,Hessen,20,33,237,10589,4.0
2020-06-21 00:00:00+00:00,Hessen,7,34,238,10596,4.0
2020-06-22 00:00:00+00:00,Hessen,20,35,250,10616,4.0
2020-06-23 00:00:00+00:00,Hessen,38,35,248,10654,4.0
2020-06-24 00:00:00+00:00,Hessen,27,31,218,10681,3.0
2020-06-25 00:00:00+00:00,Hessen,39,29,209,10720,3.0
2020-06-26 00:00:00+00:00,Hessen,29,25,180,10749,3.0
2020-06-27 00:00:00+00:00,Hessen,19,25,179,10768,3.0
2020-06-28 00:00:00+00:00,Hessen,2,24,174,10770,3.0
2020-06-29 00:00:00+00:00,Hessen,20,24,174,10790,3.0
2020-06-30 00:00:00+00:00,Hessen,30,23,166,10820,3.0
2020-07-01 00:00:00+00:00,Hessen,50,27,189,10870,3.0
2020-07-02 00:00:00+00:00,Hessen,29,25,179,10899,3.0
2020-07-03 00:00:00+00:00,Hessen,31,25,181,10930,3.0
2020-07-04 00:00:00+00:00,Hessen,17,25,179,10947,3.0
2020-07-05 00:00:00+00:00,Hessen,10,26,187,10957,3.0
2020-07-06 00:00:00+00:00,Hessen,27,27,194,10984,3.0
2020-07-07 00:00:00+00:00,Hessen,29,27,193,11013,3.0
2020-07-08 00:00:00+00:00,Hessen,52,27,195,11065,3.0
2020-07-09 00:00:00+00:00,Hessen,39,29,205,11104,3.0
2020-07-10 00:00:00+00:00,Hessen,42,30,216,11146,3.0
2020-07-11 00:00:00+00:00,Hessen,28,32,227,11174,4.0
2020-07-12 00:00:00+00:00,Hessen,3,31,220,11177,3.0
2020-07-13 00:00:00+00:00,Hessen,31,32,224,11208,4.0
2020-07-14 00:00:00+00:00,Hessen,40,33,235,11248,4.0
2020-07-15 00:00:00+00:00,Hessen,48,33,231,11296,4.0
2020-07-16 00:00:00+00:00,Hessen,40,33,232,11336,4.0
2020-07-17 00:00:00+00:00,Hessen,38,32,228,11374,4.0
2020-07-18 00:00:00+00:00,Hessen,33,33,233,11407,4.0
2020-07-19 00:00:00+00:00,Hessen,9,34,239,11416,4.0
2020-07-20 00:00:00+00:00,Hessen,26,33,234,11442,4.0
2020-07-21 00:00:00+00:00,Hessen,27,31,221,11469,4.0
2020-07-22 00:00:00+00:00,Hessen,71,34,244,11540,4.0
2020-07-23 00:00:00+00:00,Hessen,57,37,261,11597,4.0
2020-07-24 00:00:00+00:00,Hessen,71,42,294,11668,5.0
2020-07-25 00:00:00+00:00,Hessen,34,42,295,11702,5.0
2020-07-26 00:00:00+00:00,Hessen,5,41,291,11707,5.0
2020-07-27 00:00:00+00:00,Hessen,59,46,324,11766,5.0
2020-07-28 00:00:00+00:00,Hessen,64,51,361,11830,6.0
2020-07-29 00:00:00+00:00,Hessen,84,53,374,11914,6.0
2020-07-30 00:00:00+00:00,Hessen,81,56,398,11995,6.0
2020-07-31 00:00:00+00:00,Hessen,84,58,411,12079,7.0
2020-08-01 00:00:00+00:00,Hessen,50,61,427,12129,7.0
2020-08-02 00:00:00+00:00,Hessen,21,63,443,12150,7.0
2020-08-03 00:00:00+00:00,Hessen,69,64,453,12219,7.0
2020-08-04 00:00:00+00:00,Hessen,74,66,463,12293,7.0
2020-08-05 00:00:00+00:00,Hessen,116,70,495,12409,8.0
2020-08-06 00:00:00+00:00,Hessen,121,76,535,12530,9.0
2020-08-07 00:00:00+00:00,Hessen,123,82,574,12653,9.0
2020-08-08 00:00:00+00:00,Hessen,76,85,600,12729,10.0
2020-08-09 00:00:00+00:00,Hessen,18,85,597,12747,9.0
2020-08-10 00:00:00+00:00,Hessen,101,89,629,12848,10.0
2020-08-11 00:00:00+00:00,Hessen,98,93,653,12946,10.0
2020-08-12 00:00:00+00:00,Hessen,155,98,692,13101,11.0
2020-08-13 00:00:00+00:00,Hessen,185,108,756,13286,12.0
2020-08-14 00:00:00+00:00,Hessen,149,111,782,13435,12.0
2020-08-15 00:00:00+00:00,Hessen,61,109,767,13496,12.0
2020-08-16 00:00:00+00:00,Hessen,48,113,797,13544,13.0
2020-08-17 00:00:00+00:00,Hessen,187,126,883,13731,14.0
2020-08-18 00:00:00+00:00,Hessen,140,132,925,13871,15.0
2020-08-19 00:00:00+00:00,Hessen,208,139,978,14079,16.0
2020-08-20 00:00:00+00:00,Hessen,215,144,1008,14294,16.0
2020-08-21 00:00:00+00:00,Hessen,209,152,1068,14503,17.0
2020-08-22 00:00:00+00:00,Hessen,132,162,1139,14635,18.0
2020-08-23 00:00:00+00:00,Hessen,53,163,1144,14688,18.0
2020-08-24 00:00:00+00:00,Hessen,173,161,1130,14861,18.0
2020-08-25 00:00:00+00:00,Hessen,176,166,1166,15037,19.0
2020-08-26 00:00:00+00:00,Hessen,109,152,1067,15146,17.0
2020-08-27 00:00:00+00:00,Hessen,122,139,974,15268,15.0
2020-08-28 00:00:00+00:00,Hessen,118,126,883,15386,14.0
2020-08-29 00:00:00+00:00,Hessen,54,115,805,15440,13.0
2020-08-30 00:00:00+00:00,Hessen,41,113,793,15481,13.0
2020-08-31 00:00:00+00:00,Hessen,129,107,749,15610,12.0
2020-09-01 00:00:00+00:00,Hessen,105,96,678,15715,11.0
2020-09-02 00:00:00+00:00,Hessen,83,93,652,15798,10.0
2020-09-03 00:00:00+00:00,Hessen,145,96,675,15943,11.0
2020-09-04 00:00:00+00:00,Hessen,108,95,665,16051,11.0
2020-09-05 00:00:00+00:00,Hessen,73,97,684,16124,11.0
2020-09-06 00:00:00+00:00,Hessen,56,99,699,16180,11.0
2020-09-07 00:00:00+00:00,Hessen,127,99,697,16307,11.0
2020-09-08 00:00:00+00:00,Hessen,91,97,683,16398,11.0
2020-09-09 00:00:00+00:00,Hessen,113,101,713,16511,11.0
2020-09-10 00:00:00+00:00,Hessen,102,95,670,16613,11.0
2020-09-11 00:00:00+00:00,Hessen,129,98,691,16742,11.0
2020-09-12 00:00:00+00:00,Hessen,93,101,711,16835,11.0
2020-09-13 00:00:00+00:00,Hessen,63,102,718,16898,11.0
2020-09-14 00:00:00+00:00,Hessen,102,99,693,17000,11.0
2020-09-15 00:00:00+00:00,Hessen,97,99,699,17097,11.0
2020-09-16 00:00:00+00:00,Hessen,176,108,762,17273,12.0
2020-09-17 00:00:00+00:00,Hessen,146,115,806,17419,13.0
2020-09-18 00:00:00+00:00,Hessen,119,113,796,17538,13.0
2020-09-19 00:00:00+00:00,Hessen,74,111,777,17612,12.0
2020-09-20 00:00:00+00:00,Hessen,34,106,748,17646,12.0
2020-09-21 00:00:00+00:00,Hessen,119,109,765,17765,12.0
2020-09-22 00:00:00+00:00,Hessen,125,113,793,17890,13.0
2020-09-23 00:00:00+00:00,Hessen,169,112,786,18059,12.0
2020-09-24 00:00:00+00:00,Hessen,209,121,849,18268,14.0
2020-09-25 00:00:00+00:00,Hessen,216,135,946,18484,15.0
2020-09-26 00:00:00+00:00,Hessen,133,143,1005,18617,16.0
2020-09-27 00:00:00+00:00,Hessen,57,146,1028,18674,16.0
2020-09-28 00:00:00+00:00,Hessen,142,150,1051,18816,17.0
2020-09-29 00:00:00+00:00,Hessen,148,153,1074,18964,17.0
2020-09-30 00:00:00+00:00,Hessen,246,164,1151,19210,18.0
2020-10-01 00:00:00+00:00,Hessen,251,170,1193,19461,19.0
2020-10-02 00:00:00+00:00,Hessen,237,173,1214,19698,19.0
2020-10-03 00:00:00+00:00,Hessen,208,184,1289,19906,20.0
2020-10-04 00:00:00+00:00,Hessen,76,186,1308,19982,21.0
2020-10-05 00:00:00+00:00,Hessen,181,192,1347,20163,21.0
2020-10-06 00:00:00+00:00,Hessen,332,218,1531,20495,24.0
2020-10-07 00:00:00+00:00,Hessen,362,235,1647,20857,26.0
2020-10-08 00:00:00+00:00,Hessen,356,250,1752,21213,28.0
2020-10-09 00:00:00+00:00,Hessen,464,282,1979,21677,31.0
2020-10-10 00:00:00+00:00,Hessen,327,299,2098,22004,33.0
2020-10-11 00:00:00+00:00,Hessen,131,307,2153,22135,34.0
2020-10-12 00:00:00+00:00,Hessen,361,333,2333,22496,37.0
2020-10-13 00:00:00+00:00,Hessen,411,344,2412,22907,38.0
2020-10-14 00:00:00+00:00,Hessen,724,396,2774,23631,44.0
2020-10-15 00:00:00+00:00,Hessen,691,444,3109,24322,49.0
2020-10-16 00:00:00+00:00,Hessen,888,504,3533,25210,56.0
2020-10-17 00:00:00+00:00,Hessen,455,523,3661,25665,58.0
2020-10-18 00:00:00+00:00,Hessen,315,549,3845,25980,61.0
2020-10-19 00:00:00+00:00,Hessen,692,596,4176,26672,66.0
2020-10-20 00:00:00+00:00,Hessen,877,663,4642,27549,74.0
2020-10-21 00:00:00+00:00,Hessen,1212,732,5130,28761,82.0
2020-10-22 00:00:00+00:00,Hessen,1152,798,5591,29913,89.0
2020-10-23 00:00:00+00:00,Hessen,1582,897,6285,31495,100.0
2020-10-24 00:00:00+00:00,Hessen,1199,1004,7029,32694,112.0
2020-10-25 00:00:00+00:00,Hessen,545,1037,7259,33239,115.0
2020-10-26 00:00:00+00:00,Hessen,1289,1122,7856,34528,125.0
2020-10-27 00:00:00+00:00,Hessen,1473,1207,8452,36001,134.0
2020-10-28 00:00:00+00:00,Hessen,1869,1301,9109,37870,145.0
2020-10-29 00:00:00+00:00,Hessen,1703,1380,9660,39573,154.0
2020-10-30 00:00:00+00:00,Hessen,1687,1395,9765,41260,155.0
2020-10-31 00:00:00+00:00,Hessen,1434,1428,10000,42694,159.0
2020-11-01 00:00:00+00:00,Hessen,923,1482,10378,43617,165.0
2020-11-02 00:00:00+00:00,Hessen,1216,1472,10305,44833,164.0
2020-11-03 00:00:00+00:00,Hessen,1560,1484,10392,46393,165.0
2020-11-04 00:00:00+00:00,Hessen,1859,1483,10382,48252,165.0
2020-11-05 00:00:00+00:00,Hessen,1749,1489,10428,50001,166.0
2020-11-06 00:00:00+00:00,Hessen,1853,1513,10594,51854,168.0
2020-11-07 00:00:00+00:00,Hessen,1742,1557,10902,53596,173.0
2020-11-08 00:00:00+00:00,Hessen,848,1546,10827,54444,172.0
2020-11-09 00:00:00+00:00,Hessen,1697,1615,11308,56141,180.0
2020-11-10 00:00:00+00:00,Hessen,1870,1659,11618,58011,185.0
2020-11-11 00:00:00+00:00,Hessen,1875,1662,11634,59886,185.0
2020-11-12 00:00:00+00:00,Hessen,1819,1672,11704,61705,186.0
2020-11-13 00:00:00+00:00,Hessen,1870,1674,11721,63575,186.0
2020-11-14 00:00:00+00:00,Hessen,1432,1630,11411,65007,181.0
2020-11-15 00:00:00+00:00,Hessen,838,1628,11401,65845,181.0
2020-11-16 00:00:00+00:00,Hessen,1203,1558,10907,67048,173.0
2020-11-17 00:00:00+00:00,Hessen,1979,1573,11016,69027,175.0
2020-11-18 00:00:00+00:00,Hessen,2252,1627,11393,71279,181.0
2020-11-19 00:00:00+00:00,Hessen,1993,1652,11567,73272,184.0
2020-11-20 00:00:00+00:00,Hessen,1904,1657,11601,75176,184.0
2020-11-21 00:00:00+00:00,Hessen,1447,1659,11616,76623,185.0
2020-11-22 00:00:00+00:00,Hessen,666,1634,11444,77289,182.0
2020-11-23 00:00:00+00:00,Hessen,1056,1613,11297,78345,180.0
2020-11-24 00:00:00+00:00,Hessen,1375,1527,10693,79720,170.0
2020-11-25 00:00:00+00:00,Hessen,1903,1477,10344,81623,165.0
2020-11-26 00:00:00+00:00,Hessen,1889,1462,10240,83512,163.0
2020-11-27 00:00:00+00:00,Hessen,1890,1460,10226,85402,163.0
2020-11-28 00:00:00+00:00,Hessen,1272,1435,10051,86674,160.0
2020-11-29 00:00:00+00:00,Hessen,566,1421,9951,87240,158.0
2020-11-30 00:00:00+00:00,Hessen,971,1409,9866,88211,157.0
2020-12-01 00:00:00+00:00,Hessen,1364,1407,9855,89575,157.0
2020-12-02 00:00:00+00:00,Hessen,1747,1385,9699,91322,154.0
2020-12-03 00:00:00+00:00,Hessen,1848,1379,9658,93170,154.0
2020-12-04 00:00:00+00:00,Hessen,1801,1367,9569,94971,152.0
2020-12-05 00:00:00+00:00,Hessen,1231,1361,9528,96202,152.0
2020-12-06 00:00:00+00:00,Hessen,668,1375,9630,96870,153.0
2020-12-07 00:00:00+00:00,Hessen,1227,1412,9886,98097,157.0
2020-12-08 00:00:00+00:00,Hessen,1830,1478,10352,99927,165.0
2020-12-09 00:00:00+00:00,Hessen,2054,1522,10659,101981,170.0
2020-12-10 00:00:00+00:00,Hessen,2210,1574,11021,104191,175.0
2020-12-11 00:00:00+00:00,Hessen,2119,1619,11339,106310,180.0
2020-12-12 00:00:00+00:00,Hessen,1707,1687,11815,108017,188.0
2020-12-13 00:00:00+00:00,Hessen,742,1698,11889,108759,189.0
2020-12-14 00:00:00+00:00,Hessen,1270,1704,11932,110029,190.0
2020-12-15 00:00:00+00:00,Hessen,1867,1709,11969,111896,190.0
2020-12-16 00:00:00+00:00,Hessen,2601,1788,12516,114497,199.0
2020-12-17 00:00:00+00:00,Hessen,2420,1818,12726,116917,202.0
2020-12-18 00:00:00+00:00,Hessen,2436,1863,13043,119353,207.0
2020-12-19 00:00:00+00:00,Hessen,1777,1873,13113,121130,209.0
2020-12-20 00:00:00+00:00,Hessen,959,1904,13330,122089,212.0
2020-12-21 00:00:00+00:00,Hessen,1228,1898,13288,123317,211.0
2020-12-22 00:00:00+00:00,Hessen,2088,1929,13509,125405,215.0
2020-12-23 00:00:00+00:00,Hessen,2742,1950,13650,128147,217.0
2020-12-24 00:00:00+00:00,Hessen,1803,1861,13033,129950,207.0
2020-12-25 00:00:00+00:00,Hessen,848,1635,11445,130798,182.0
2020-12-26 00:00:00+00:00,Hessen,606,1467,10274,131404,163.0
2020-12-27 00:00:00+00:00,Hessen,444,1394,9759,131848,155.0
2020-12-28 00:00:00+00:00,Hessen,834,1337,9365,132682,149.0
2020-12-29 00:00:00+00:00,Hessen,2018,1327,9295,134700,148.0
2020-12-30 00:00:00+00:00,Hessen,2289,1263,8842,136989,141.0
2020-12-31 00:00:00+00:00,Hessen,1667,1243,8706,138656,138.0
2021-01-01 00:00:00+00:00,Hessen,818,1239,8676,139474,138.0
2021-01-02 00:00:00+00:00,Hessen,486,1222,8556,139960,136.0
2021-01-03 00:00:00+00:00,Hessen,497,1229,8609,140457,137.0
2021-01-04 00:00:00+00:00,Hessen,837,1230,8612,141294,137.0
2021-01-05 00:00:00+00:00,Hessen,2013,1229,8607,143307,137.0
2021-01-06 00:00:00+00:00,Hessen,2207,1217,8525,145514,136.0
2021-01-07 00:00:00+00:00,Hessen,1875,1247,8733,147389,139.0
2021-01-08 00:00:00+00:00,Hessen,1632,1363,9547,149021,152.0
2021-01-09 00:00:00+00:00,Hessen,1253,1473,10314,150274,164.0
2021-01-10 00:00:00+00:00,Hessen,451,1466,10268,150725,163.0
2021-01-11 00:00:00+00:00,Hessen,740,1453,10171,151465,162.0
2021-01-12 00:00:00+00:00,Hessen,1599,1393,9757,153064,155.0
2021-01-13 00:00:00+00:00,Hessen,1719,1324,9269,154783,147.0
2021-01-14 00:00:00+00:00,Hessen,1525,1274,8919,156308,142.0
2021-01-15 00:00:00+00:00,Hessen,1317,1229,8604,157625,137.0
2021-01-16 00:00:00+00:00,Hessen,1089,1205,8440,158714,134.0
2021-01-17 00:00:00+00:00,Hessen,418,1201,8407,159132,134.0
2021-01-18 00:00:00+00:00,Hessen,464,1161,8131,159596,129.0
2021-01-19 00:00:00+00:00,Hessen,1341,1124,7873,160937,125.0
2021-01-20 00:00:00+00:00,Hessen,1590,1106,7744,162527,123.0
2021-01-21 00:00:00+00:00,Hessen,1411,1090,7630,163938,121.0
2021-01-22 00:00:00+00:00,Hessen,1141,1064,7454,165079,119.0
2021-01-23 00:00:00+00:00,Hessen,823,1026,7188,165902,114.0
2021-01-24 00:00:00+00:00,Hessen,274,1006,7044,166176,112.0
2021-01-25 00:00:00+00:00,Hessen,414,999,6994,166590,111.0
2021-01-26 00:00:00+00:00,Hessen,1102,965,6755,167692,107.0
2021-01-27 00:00:00+00:00,Hessen,1275,920,6440,168967,102.0
2021-01-28 00:00:00+00:00,Hessen,1009,862,6038,169976,96.0
2021-01-29 00:00:00+00:00,Hessen,959,836,5856,170935,93.0
2021-01-30 00:00:00+00:00,Hessen,823,836,5856,171758,93.0
2021-01-31 00:00:00+00:00,Hessen,227,829,5809,171985,92.0
2021-02-01 00:00:00+00:00,Hessen,390,826,5785,172375,92.0
2021-02-02 00:00:00+00:00,Hessen,963,806,5646,173338,90.0
2021-02-03 00:00:00+00:00,Hessen,1148,788,5519,174486,88.0
2021-02-04 00:00:00+00:00,Hessen,889,771,5399,175375,86.0
2021-02-05 00:00:00+00:00,Hessen,734,739,5174,176109,82.0
2021-02-06 00:00:00+00:00,Hessen,727,725,5078,176836,81.0
2021-02-07 00:00:00+00:00,Hessen,185,719,5036,177021,80.0
2021-02-08 00:00:00+00:00,Hessen,247,699,4893,177268,78.0
2021-02-09 00:00:00+00:00,Hessen,649,654,4579,177917,73.0
2021-02-10 00:00:00+00:00,Hessen,837,609,4268,178754,68.0
2021-02-11 00:00:00+00:00,Hessen,644,574,4023,179398,64.0
2021-02-12 00:00:00+00:00,Hessen,588,553,3877,179986,62.0
2021-02-13 00:00:00+00:00,Hessen,392,506,3542,180378,56.0
2021-02-14 00:00:00+00:00,Hessen,215,510,3572,180593,57.0
2021-02-15 00:00:00+00:00,Hessen,268,513,3593,180861,57.0
2021-02-16 00:00:00+00:00,Hessen,701,520,3645,181562,58.0
2021-02-17 00:00:00+00:00,Hessen,760,509,3568,182322,57.0
2021-02-18 00:00:00+00:00,Hessen,725,521,3649,183047,58.0
2021-02-19 00:00:00+00:00,Hessen,611,524,3672,183658,58.0
2021-02-20 00:00:00+00:00,Hessen,612,556,3892,184270,62.0
2021-02-21 00:00:00+00:00,Hessen,112,541,3789,184382,60.0
2021-02-22 00:00:00+00:00,Hessen,340,551,3861,184722,61.0
2021-02-23 00:00:00+00:00,Hessen,783,563,3943,185505,63.0
2021-02-24 00:00:00+00:00,Hessen,767,564,3950,186272,63.0
2021-02-25 00:00:00+00:00,Hessen,718,563,3943,186990,63.0
2021-02-26 00:00:00+00:00,Hessen,811,591,4143,187801,66.0
2021-02-27 00:00:00+00:00,Hessen,563,584,4094,188364,65.0
2021-02-28 00:00:00+00:00,Hessen,174,593,4156,188538,66.0
2021-03-01 00:00:00+00:00,Hessen,408,603,4224,188946,67.0
2021-03-02 00:00:00+00:00,Hessen,835,610,4276,189781,68.0
2021-03-03 00:00:00+00:00,Hessen,875,626,4384,190656,70.0
2021-03-04 00:00:00+00:00,Hessen,795,637,4461,191451,71.0
2021-03-05 00:00:00+00:00,Hessen,727,625,4377,192178,70.0
2021-03-06 00:00:00+00:00,Hessen,745,651,4559,192923,73.0
2021-03-07 00:00:00+00:00,Hessen,193,654,4578,193116,73.0
2021-03-08 00:00:00+00:00,Hessen,300,638,4470,193416,71.0
2021-03-09 00:00:00+00:00,Hessen,923,651,4558,194339,72.0
2021-03-10 00:00:00+00:00,Hessen,1109,684,4792,195448,76.0
2021-03-11 00:00:00+00:00,Hessen,1009,715,5006,196457,80.0
2021-03-12 00:00:00+00:00,Hessen,1029,758,5308,197486,84.0
2021-03-13 00:00:00+00:00,Hessen,937,785,5500,198423,87.0
2021-03-14 00:00:00+00:00,Hessen,352,808,5659,198775,90.0
2021-03-15 00:00:00+00:00,Hessen,545,843,5904,199320,94.0
2021-03-16 00:00:00+00:00,Hessen,1270,893,6251,200590,99.0
2021-03-17 00:00:00+00:00,Hessen,1567,958,6709,202157,107.0
2021-03-18 00:00:00+00:00,Hessen,1285,997,6985,203442,111.0
2021-03-19 00:00:00+00:00,Hessen,1393,1049,7349,204835,117.0
2021-03-20 00:00:00+00:00,Hessen,1197,1087,7609,206032,121.0
2021-03-21 00:00:00+00:00,Hessen,357,1087,7614,206389,121.0
2021-03-22 00:00:00+00:00,Hessen,704,1110,7773,207093,124.0
2021-03-23 00:00:00+00:00,Hessen,1554,1151,8057,208647,128.0
2021-03-24 00:00:00+00:00,Hessen,2008,1214,8498,210655,135.0
2021-03-25 00:00:00+00:00,Hessen,1663,1268,8876,212318,141.0
2021-03-26 00:00:00+00:00,Hessen,1569,1293,9052,213887,144.0
2021-03-27 00:00:00+00:00,Hessen,1174,1289,9029,215061,144.0
2021-03-28 00:00:00+00:00,Hessen,555,1318,9227,215616,147.0
2021-03-29 00:00:00+00:00,Hessen,1002,1360,9525,216618,151.0
2021-03-30 00:00:00+00:00,Hessen,1637,1372,9608,218255,153.0
2021-03-31 00:00:00+00:00,Hessen,1980,1368,9580,220235,152.0
2021-04-01 00:00:00+00:00,Hessen,1984,1414,9901,222219,157.0
2021-04-02 00:00:00+00:00,Hessen,1275,1372,9607,223494,153.0
2021-04-03 00:00:00+00:00,Hessen,614,1292,9047,224108,144.0
2021-04-04 00:00:00+00:00,Hessen,455,1278,8947,224563,142.0
2021-04-05 00:00:00+00:00,Hessen,662,1229,8607,225225,137.0
2021-04-06 00:00:00+00:00,Hessen,862,1118,7832,226087,125.0
2021-04-07 00:00:00+00:00,Hessen,1783,1090,7635,227870,121.0
2021-04-08 00:00:00+00:00,Hessen,2042,1099,7693,229912,122.0
2021-04-09 00:00:00+00:00,Hessen,1930,1192,8348,231842,133.0
2021-04-10 00:00:00+00:00,Hessen,1490,1317,9224,233332,147.0
2021-04-11 00:00:00+00:00,Hessen,437,1315,9206,233769,146.0
2021-04-12 00:00:00+00:00,Hessen,942,1355,9486,234711,151.0
2021-04-13 00:00:00+00:00,Hessen,2127,1535,10751,236838,171.0
2021-04-14 00:00:00+00:00,Hessen,2081,1578,11049,238919,176.0
2021-04-15 00:00:00+00:00,Hessen,1709,1530,10716,240628,170.0
2021-04-16 00:00:00+00:00,Hessen,1564,1478,10350,242192,165.0
2021-04-17 00:00:00+00:00,Hessen,1434,1470,10294,243626,164.0
2021-04-18 00:00:00+00:00,Hessen,608,1495,10465,244234,166.0
2021-04-19 00:00:00+00:00,Hessen,789,1473,10312,245023,164.0
2021-04-20 00:00:00+00:00,Hessen,2120,1472,10305,247143,164.0
2021-04-21 00:00:00+00:00,Hessen,2441,1523,10665,249584,170.0
2021-04-22 00:00:00+00:00,Hessen,1976,1561,10932,251560,174.0
2021-04-23 00:00:00+00:00,Hessen,2001,1624,11369,253561,181.0
2021-04-24 00:00:00+00:00,Hessen,1462,1628,11397,255023,181.0
2021-04-25 00:00:00+00:00,Hessen,677,1638,11466,255700,182.0
2021-04-26 00:00:00+00:00,Hessen,776,1636,11453,256476,182.0
2021-04-27 00:00:00+00:00,Hessen,2204,1648,11537,258680,183.0
2021-04-28 00:00:00+00:00,Hessen,1952,1578,11048,260632,176.0
2021-04-29 00:00:00+00:00,Hessen,1650,1531,10722,262282,171.0
2021-04-30 00:00:00+00:00,Hessen,1516,1462,10237,263798,163.0
2021-05-01 00:00:00+00:00,Hessen,1227,1428,10002,265025,159.0
2021-05-02 00:00:00+00:00,Hessen,405,1390,9730,265430,155.0
2021-05-03 00:00:00+00:00,Hessen,521,1353,9475,265951,151.0
2021-05-04 00:00:00+00:00,Hessen,1712,1283,8983,267663,143.0
2021-05-05 00:00:00+00:00,Hessen,1611,1234,8642,269274,137.0
2021-05-06 00:00:00+00:00,Hessen,1319,1187,8311,270593,132.0
2021-05-07 00:00:00+00:00,Hessen,1121,1130,7916,271714,126.0
2021-05-08 00:00:00+00:00,Hessen,1109,1114,7798,272823,124.0
2021-05-09 00:00:00+00:00,Hessen,334,1103,7727,273157,123.0
2021-05-10 00:00:00+00:00,Hessen,585,1113,7791,273742,124.0
2021-05-11 00:00:00+00:00,Hessen,1553,1090,7632,275295,121.0
2021-05-12 00:00:00+00:00,Hessen,1441,1066,7462,276736,119.0
2021-05-13 00:00:00+00:00,Hessen,830,996,6973,277566,111.0
2021-05-14 00:00:00+00:00,Hessen,543,913,6395,278109,102.0
2021-05-15 00:00:00+00:00,Hessen,694,854,5980,278803,95.0
2021-05-16 00:00:00+00:00,Hessen,259,843,5905,279062,94.0
2021-05-17 00:00:00+00:00,Hessen,427,821,5747,279489,91.0
2021-05-18 00:00:00+00:00,Hessen,1133,761,5327,280622,85.0
2021-05-19 00:00:00+00:00,Hessen,1001,698,4887,281623,78.0
2021-05-20 00:00:00+00:00,Hessen,760,688,4817,282383,77.0
2021-05-21 00:00:00+00:00,Hessen,678,707,4952,283061,79.0
2021-05-22 00:00:00+00:00,Hessen,593,693,4851,283654,77.0
2021-05-23 00:00:00+00:00,Hessen,117,672,4709,283771,75.0
2021-05-24 00:00:00+00:00,Hessen,92,624,4374,283863,70.0
2021-05-25 00:00:00+00:00,Hessen,259,500,3500,284122,56.0
2021-05-26 00:00:00+00:00,Hessen,773,467,3272,284895,52.0
2021-05-27 00:00:00+00:00,Hessen,642,450,3154,285537,50.0
2021-05-28 00:00:00+00:00,Hessen,501,425,2977,286038,47.0
2021-05-29 00:00:00+00:00,Hessen,298,383,2682,286336,43.0
2021-05-30 00:00:00+00:00,Hessen,97,380,2662,286433,42.0
2021-05-31 00:00:00+00:00,Hessen,189,394,2759,286622,44.0
2021-06-01 00:00:00+00:00,Hessen,507,429,3007,287129,48.0
2021-06-02 00:00:00+00:00,Hessen,426,380,2660,287555,42.0
2021-06-03 00:00:00+00:00,Hessen,267,326,2285,287822,36.0
2021-06-04 00:00:00+00:00,Hessen,131,273,1915,287953,30.0
2021-06-05 00:00:00+00:00,Hessen,236,264,1853,288189,29.0
2021-06-06 00:00:00+00:00,Hessen,67,260,1823,288256,29.0
2021-06-07 00:00:00+00:00,Hessen,125,251,1759,288381,28.0
2021-06-08 00:00:00+00:00,Hessen,327,225,1579,288708,25.0
2021-06-09 00:00:00+00:00,Hessen,279,204,1432,288987,23.0
2021-06-10 00:00:00+00:00,Hessen,250,202,1415,289237,23.0
2021-06-11 00:00:00+00:00,Hessen,158,206,1442,289395,23.0
2021-06-12 00:00:00+00:00,Hessen,108,187,1314,289503,21.0
2021-06-13 00:00:00+00:00,Hessen,37,183,1284,289540,20.0
2021-06-14 00:00:00+00:00,Hessen,79,176,1238,289619,20.0
2021-06-15 00:00:00+00:00,Hessen,123,147,1034,289742,16.0
2021-06-16 00:00:00+00:00,Hessen,143,128,898,289885,14.0
2021-06-17 00:00:00+00:00,Hessen,115,109,763,290000,12.0
2021-06-18 00:00:00+00:00,Hessen,96,100,701,290096,11.0
2021-06-19 00:00:00+00:00,Hessen,59,93,652,290155,10.0
2021-06-20 00:00:00+00:00,Hessen,23,91,638,290178,10.0
2021-06-21 00:00:00+00:00,Hessen,48,86,607,290226,10.0
2021-06-22 00:00:00+00:00,Hessen,98,83,582,290324,9.0
2021-06-23 00:00:00+00:00,Hessen,90,75,529,290414,8.0
2021-06-24 00:00:00+00:00,Hessen,83,71,497,290497,8.0
2021-06-25 00:00:00+00:00,Hessen,69,67,470,290566,7.0
2021-06-26 00:00:00+00:00,Hessen,65,68,476,290631,8.0
2021-06-27 00:00:00+00:00,Hessen,28,68,481,290659,8.0
2021-06-28 00:00:00+00:00,Hessen,49,68,482,290708,8.0
2021-06-29 00:00:00+00:00,Hessen,91,67,475,290799,8.0
2021-06-30 00:00:00+00:00,Hessen,95,68,480,290894,8.0
2021-07-01 00:00:00+00:00,Hessen,93,70,490,290987,8.0
2021-07-02 00:00:00+00:00,Hessen,87,72,508,291074,8.0
2021-07-03 00:00:00+00:00,Hessen,67,72,510,291141,8.0
2021-07-04 00:00:00+00:00,Hessen,7,69,489,291148,8.0
2021-07-05 00:00:00+00:00,Hessen,48,69,488,291196,8.0
2021-07-06 00:00:00+00:00,Hessen,106,71,503,291302,8.0
2020-02-28 00:00:00+00:00,Rheinland-Pfalz,1,0,0,1,0.0
2020-02-29 00:00:00+00:00,Rheinland-Pfalz,1,0,0,2,0.0
2020-03-03 00:00:00+00:00,Rheinland-Pfalz,1,0,0,3,0.0
2020-03-04 00:00:00+00:00,Rheinland-Pfalz,4,0,0,7,0.0
2020-03-05 00:00:00+00:00,Rheinland-Pfalz,1,0,0,8,0.0
2020-03-06 00:00:00+00:00,Rheinland-Pfalz,2,0,0,10,0.0
2020-03-07 00:00:00+00:00,Rheinland-Pfalz,2,1,12,12,0.0
2020-03-08 00:00:00+00:00,Rheinland-Pfalz,3,2,14,15,0.0
2020-03-09 00:00:00+00:00,Rheinland-Pfalz,6,2,19,21,0.0
2020-03-10 00:00:00+00:00,Rheinland-Pfalz,17,5,35,38,1.0
2020-03-11 00:00:00+00:00,Rheinland-Pfalz,30,8,61,68,1.0
2020-03-12 00:00:00+00:00,Rheinland-Pfalz,64,17,124,132,3.0
2020-03-13 00:00:00+00:00,Rheinland-Pfalz,58,25,180,190,4.0
2020-03-14 00:00:00+00:00,Rheinland-Pfalz,51,32,229,241,6.0
2020-03-15 00:00:00+00:00,Rheinland-Pfalz,95,45,321,336,8.0
2020-03-16 00:00:00+00:00,Rheinland-Pfalz,125,62,440,461,11.0
2020-03-17 00:00:00+00:00,Rheinland-Pfalz,168,84,591,629,14.0
2020-03-18 00:00:00+00:00,Rheinland-Pfalz,157,102,718,786,18.0
2020-03-19 00:00:00+00:00,Rheinland-Pfalz,135,112,789,921,19.0
2020-03-20 00:00:00+00:00,Rheinland-Pfalz,180,130,911,1101,22.0
2020-03-21 00:00:00+00:00,Rheinland-Pfalz,115,139,975,1216,24.0
2020-03-22 00:00:00+00:00,Rheinland-Pfalz,142,146,1022,1358,25.0
2020-03-23 00:00:00+00:00,Rheinland-Pfalz,196,156,1093,1554,27.0
2020-03-24 00:00:00+00:00,Rheinland-Pfalz,205,161,1130,1759,28.0
2020-03-25 00:00:00+00:00,Rheinland-Pfalz,170,163,1143,1929,28.0
2020-03-26 00:00:00+00:00,Rheinland-Pfalz,215,174,1223,2144,30.0
2020-03-27 00:00:00+00:00,Rheinland-Pfalz,270,187,1313,2414,32.0
2020-03-28 00:00:00+00:00,Rheinland-Pfalz,165,194,1363,2579,33.0
2020-03-29 00:00:00+00:00,Rheinland-Pfalz,142,194,1363,2721,33.0
2020-03-30 00:00:00+00:00,Rheinland-Pfalz,143,187,1310,2864,32.0
2020-03-31 00:00:00+00:00,Rheinland-Pfalz,201,186,1306,3065,32.0
2020-04-01 00:00:00+00:00,Rheinland-Pfalz,252,198,1388,3317,34.0
2020-04-02 00:00:00+00:00,Rheinland-Pfalz,189,194,1362,3506,33.0
2020-04-03 00:00:00+00:00,Rheinland-Pfalz,214,186,1306,3720,32.0
2020-04-04 00:00:00+00:00,Rheinland-Pfalz,140,183,1281,3860,31.0
2020-04-05 00:00:00+00:00,Rheinland-Pfalz,105,177,1244,3965,30.0
2020-04-06 00:00:00+00:00,Rheinland-Pfalz,138,177,1239,4103,30.0
2020-04-07 00:00:00+00:00,Rheinland-Pfalz,180,174,1218,4283,30.0
2020-04-08 00:00:00+00:00,Rheinland-Pfalz,172,162,1138,4455,28.0
2020-04-09 00:00:00+00:00,Rheinland-Pfalz,156,157,1105,4611,27.0
2020-04-10 00:00:00+00:00,Rheinland-Pfalz,131,146,1022,4742,25.0
2020-04-11 00:00:00+00:00,Rheinland-Pfalz,77,137,959,4819,23.0
2020-04-12 00:00:00+00:00,Rheinland-Pfalz,65,131,919,4884,22.0
2020-04-13 00:00:00+00:00,Rheinland-Pfalz,73,122,854,4957,21.0
2020-04-14 00:00:00+00:00,Rheinland-Pfalz,100,110,774,5057,19.0
2020-04-15 00:00:00+00:00,Rheinland-Pfalz,119,103,721,5176,18.0
2020-04-16 00:00:00+00:00,Rheinland-Pfalz,116,97,681,5292,17.0
2020-04-17 00:00:00+00:00,Rheinland-Pfalz,129,97,679,5421,17.0
2020-04-18 00:00:00+00:00,Rheinland-Pfalz,87,98,689,5508,17.0
2020-04-19 00:00:00+00:00,Rheinland-Pfalz,26,92,650,5534,16.0
2020-04-20 00:00:00+00:00,Rheinland-Pfalz,35,87,612,5569,15.0
2020-04-21 00:00:00+00:00,Rheinland-Pfalz,61,81,573,5630,14.0
2020-04-22 00:00:00+00:00,Rheinland-Pfalz,85,77,539,5715,13.0
2020-04-23 00:00:00+00:00,Rheinland-Pfalz,55,68,478,5770,12.0
2020-04-24 00:00:00+00:00,Rheinland-Pfalz,62,58,411,5832,10.0
2020-04-25 00:00:00+00:00,Rheinland-Pfalz,30,50,354,5862,9.0
2020-04-26 00:00:00+00:00,Rheinland-Pfalz,30,51,358,5892,9.0
2020-04-27 00:00:00+00:00,Rheinland-Pfalz,42,52,365,5934,9.0
2020-04-28 00:00:00+00:00,Rheinland-Pfalz,31,47,335,5965,8.0
2020-04-29 00:00:00+00:00,Rheinland-Pfalz,61,44,311,6026,8.0
2020-04-30 00:00:00+00:00,Rheinland-Pfalz,46,43,302,6072,7.0
2020-05-01 00:00:00+00:00,Rheinland-Pfalz,39,39,279,6111,7.0
2020-05-02 00:00:00+00:00,Rheinland-Pfalz,20,38,269,6131,7.0
2020-05-04 00:00:00+00:00,Rheinland-Pfalz,28,38,267,6159,7.0
2020-05-05 00:00:00+00:00,Rheinland-Pfalz,32,36,257,6191,6.0
2020-05-06 00:00:00+00:00,Rheinland-Pfalz,30,36,256,6221,6.0
2020-05-07 00:00:00+00:00,Rheinland-Pfalz,37,33,232,6258,6.0
2020-05-08 00:00:00+00:00,Rheinland-Pfalz,24,30,210,6282,5.0
2020-05-09 00:00:00+00:00,Rheinland-Pfalz,28,28,199,6310,5.0
2020-05-10 00:00:00+00:00,Rheinland-Pfalz,15,27,194,6325,5.0
2020-05-11 00:00:00+00:00,Rheinland-Pfalz,19,26,185,6344,5.0
2020-05-12 00:00:00+00:00,Rheinland-Pfalz,21,24,174,6365,4.0
2020-05-13 00:00:00+00:00,Rheinland-Pfalz,39,26,183,6404,4.0
2020-05-14 00:00:00+00:00,Rheinland-Pfalz,30,25,176,6434,4.0
2020-05-15 00:00:00+00:00,Rheinland-Pfalz,35,26,187,6469,5.0
2020-05-16 00:00:00+00:00,Rheinland-Pfalz,10,24,169,6479,4.0
2020-05-17 00:00:00+00:00,Rheinland-Pfalz,17,24,171,6496,4.0
2020-05-18 00:00:00+00:00,Rheinland-Pfalz,19,24,171,6515,4.0
2020-05-19 00:00:00+00:00,Rheinland-Pfalz,22,24,172,6537,4.0
2020-05-20 00:00:00+00:00,Rheinland-Pfalz,30,23,163,6567,4.0
2020-05-21 00:00:00+00:00,Rheinland-Pfalz,6,19,139,6573,3.0
2020-05-22 00:00:00+00:00,Rheinland-Pfalz,12,16,116,6585,3.0
2020-05-23 00:00:00+00:00,Rheinland-Pfalz,7,16,113,6592,3.0
2020-05-24 00:00:00+00:00,Rheinland-Pfalz,1,13,97,6593,2.0
2020-05-25 00:00:00+00:00,Rheinland-Pfalz,11,12,89,6604,2.0
2020-05-26 00:00:00+00:00,Rheinland-Pfalz,40,15,107,6644,3.0
2020-05-27 00:00:00+00:00,Rheinland-Pfalz,21,14,98,6665,2.0
2020-05-28 00:00:00+00:00,Rheinland-Pfalz,8,14,100,6673,2.0
2020-05-29 00:00:00+00:00,Rheinland-Pfalz,19,15,107,6692,3.0
2020-05-30 00:00:00+00:00,Rheinland-Pfalz,11,15,111,6703,3.0
2020-06-01 00:00:00+00:00,Rheinland-Pfalz,3,16,113,6706,3.0
2020-06-02 00:00:00+00:00,Rheinland-Pfalz,7,15,109,6713,3.0
2020-06-03 00:00:00+00:00,Rheinland-Pfalz,15,12,84,6728,2.0
2020-06-04 00:00:00+00:00,Rheinland-Pfalz,28,13,91,6756,2.0
2020-06-05 00:00:00+00:00,Rheinland-Pfalz,22,15,105,6778,3.0
2020-06-06 00:00:00+00:00,Rheinland-Pfalz,8,13,94,6786,2.0
2020-06-07 00:00:00+00:00,Rheinland-Pfalz,1,12,84,6787,2.0
2020-06-08 00:00:00+00:00,Rheinland-Pfalz,15,13,96,6802,2.0
2020-06-09 00:00:00+00:00,Rheinland-Pfalz,16,15,105,6818,3.0
2020-06-10 00:00:00+00:00,Rheinland-Pfalz,7,13,97,6825,2.0
2020-06-11 00:00:00+00:00,Rheinland-Pfalz,1,10,70,6826,2.0
2020-06-12 00:00:00+00:00,Rheinland-Pfalz,11,8,59,6837,1.0
2020-06-13 00:00:00+00:00,Rheinland-Pfalz,1,7,52,6838,1.0
2020-06-14 00:00:00+00:00,Rheinland-Pfalz,3,7,54,6841,1.0
2020-06-15 00:00:00+00:00,Rheinland-Pfalz,9,6,48,6850,1.0
2020-06-16 00:00:00+00:00,Rheinland-Pfalz,12,6,44,6862,1.0
2020-06-17 00:00:00+00:00,Rheinland-Pfalz,17,7,54,6879,1.0
2020-06-18 00:00:00+00:00,Rheinland-Pfalz,13,9,66,6892,2.0
2020-06-19 00:00:00+00:00,Rheinland-Pfalz,11,9,66,6903,2.0
2020-06-20 00:00:00+00:00,Rheinland-Pfalz,10,10,75,6913,2.0
2020-06-21 00:00:00+00:00,Rheinland-Pfalz,1,10,73,6914,2.0
2020-06-22 00:00:00+00:00,Rheinland-Pfalz,5,9,69,6919,2.0
2020-06-23 00:00:00+00:00,Rheinland-Pfalz,17,10,74,6936,2.0
2020-06-24 00:00:00+00:00,Rheinland-Pfalz,7,9,64,6943,2.0
2020-06-25 00:00:00+00:00,Rheinland-Pfalz,13,9,64,6956,2.0
2020-06-26 00:00:00+00:00,Rheinland-Pfalz,16,9,69,6972,2.0
2020-06-27 00:00:00+00:00,Rheinland-Pfalz,10,9,69,6982,2.0
2020-06-28 00:00:00+00:00,Rheinland-Pfalz,7,10,75,6989,2.0
2020-06-29 00:00:00+00:00,Rheinland-Pfalz,15,12,85,7004,2.0
2020-06-30 00:00:00+00:00,Rheinland-Pfalz,27,13,95,7031,2.0
2020-07-01 00:00:00+00:00,Rheinland-Pfalz,29,16,117,7060,3.0
2020-07-02 00:00:00+00:00,Rheinland-Pfalz,7,15,111,7067,3.0
2020-07-03 00:00:00+00:00,Rheinland-Pfalz,8,14,103,7075,3.0
2020-07-04 00:00:00+00:00,Rheinland-Pfalz,8,14,101,7083,2.0
2020-07-05 00:00:00+00:00,Rheinland-Pfalz,1,13,95,7084,2.0
2020-07-06 00:00:00+00:00,Rheinland-Pfalz,8,12,88,7092,2.0
2020-07-07 00:00:00+00:00,Rheinland-Pfalz,7,9,68,7099,2.0
2020-07-08 00:00:00+00:00,Rheinland-Pfalz,12,7,51,7111,1.0
2020-07-09 00:00:00+00:00,Rheinland-Pfalz,18,8,62,7129,2.0
2020-07-10 00:00:00+00:00,Rheinland-Pfalz,17,10,71,7146,2.0
2020-07-11 00:00:00+00:00,Rheinland-Pfalz,22,12,85,7168,2.0
2020-07-12 00:00:00+00:00,Rheinland-Pfalz,15,14,99,7183,2.0
2020-07-13 00:00:00+00:00,Rheinland-Pfalz,29,17,120,7212,3.0
2020-07-14 00:00:00+00:00,Rheinland-Pfalz,23,19,136,7235,3.0
2020-07-15 00:00:00+00:00,Rheinland-Pfalz,22,20,146,7257,4.0
2020-07-16 00:00:00+00:00,Rheinland-Pfalz,29,22,157,7286,4.0
2020-07-17 00:00:00+00:00,Rheinland-Pfalz,12,21,152,7298,4.0
2020-07-18 00:00:00+00:00,Rheinland-Pfalz,14,20,144,7312,4.0
2020-07-19 00:00:00+00:00,Rheinland-Pfalz,13,20,142,7325,3.0
2020-07-20 00:00:00+00:00,Rheinland-Pfalz,21,19,134,7346,3.0
2020-07-21 00:00:00+00:00,Rheinland-Pfalz,16,18,127,7362,3.0
2020-07-22 00:00:00+00:00,Rheinland-Pfalz,25,18,130,7387,3.0
2020-07-23 00:00:00+00:00,Rheinland-Pfalz,10,15,111,7397,3.0
2020-07-24 00:00:00+00:00,Rheinland-Pfalz,16,16,115,7413,3.0
2020-07-25 00:00:00+00:00,Rheinland-Pfalz,16,16,117,7429,3.0
2020-07-26 00:00:00+00:00,Rheinland-Pfalz,1,15,105,7430,3.0
2020-07-27 00:00:00+00:00,Rheinland-Pfalz,17,14,101,7447,2.0
2020-07-28 00:00:00+00:00,Rheinland-Pfalz,25,15,110,7472,3.0
2020-07-29 00:00:00+00:00,Rheinland-Pfalz,21,15,106,7493,3.0
2020-07-30 00:00:00+00:00,Rheinland-Pfalz,25,17,121,7518,3.0
2020-07-31 00:00:00+00:00,Rheinland-Pfalz,12,16,117,7530,3.0
2020-08-01 00:00:00+00:00,Rheinland-Pfalz,15,16,116,7545,3.0
2020-08-02 00:00:00+00:00,Rheinland-Pfalz,6,17,121,7551,3.0
2020-08-03 00:00:00+00:00,Rheinland-Pfalz,44,21,148,7595,4.0
2020-08-04 00:00:00+00:00,Rheinland-Pfalz,29,21,152,7624,4.0
2020-08-05 00:00:00+00:00,Rheinland-Pfalz,55,26,186,7679,5.0
2020-08-06 00:00:00+00:00,Rheinland-Pfalz,31,27,192,7710,5.0
2020-08-07 00:00:00+00:00,Rheinland-Pfalz,59,34,239,7769,6.0
2020-08-08 00:00:00+00:00,Rheinland-Pfalz,54,39,278,7823,7.0
2020-08-09 00:00:00+00:00,Rheinland-Pfalz,13,40,285,7836,7.0
2020-08-10 00:00:00+00:00,Rheinland-Pfalz,56,42,297,7892,7.0
2020-08-11 00:00:00+00:00,Rheinland-Pfalz,44,44,312,7936,8.0
2020-08-12 00:00:00+00:00,Rheinland-Pfalz,54,44,311,7990,8.0
2020-08-13 00:00:00+00:00,Rheinland-Pfalz,80,51,360,8070,9.0
2020-08-14 00:00:00+00:00,Rheinland-Pfalz,60,51,361,8130,9.0
2020-08-15 00:00:00+00:00,Rheinland-Pfalz,35,48,342,8165,8.0
2020-08-16 00:00:00+00:00,Rheinland-Pfalz,32,51,361,8197,9.0
2020-08-17 00:00:00+00:00,Rheinland-Pfalz,99,57,404,8296,10.0
2020-08-18 00:00:00+00:00,Rheinland-Pfalz,72,61,432,8368,11.0
2020-08-19 00:00:00+00:00,Rheinland-Pfalz,102,68,480,8470,12.0
2020-08-20 00:00:00+00:00,Rheinland-Pfalz,58,65,458,8528,11.0
2020-08-21 00:00:00+00:00,Rheinland-Pfalz,77,67,475,8605,12.0
2020-08-22 00:00:00+00:00,Rheinland-Pfalz,51,70,491,8656,12.0
2020-08-23 00:00:00+00:00,Rheinland-Pfalz,22,68,481,8678,12.0
2020-08-24 00:00:00+00:00,Rheinland-Pfalz,59,63,441,8737,11.0
2020-08-25 00:00:00+00:00,Rheinland-Pfalz,52,60,421,8789,10.0
2020-08-26 00:00:00+00:00,Rheinland-Pfalz,61,54,380,8850,9.0
2020-08-27 00:00:00+00:00,Rheinland-Pfalz,54,53,376,8904,9.0
2020-08-28 00:00:00+00:00,Rheinland-Pfalz,96,56,395,9000,10.0
2020-08-29 00:00:00+00:00,Rheinland-Pfalz,64,58,408,9064,10.0
2020-08-30 00:00:00+00:00,Rheinland-Pfalz,25,58,411,9089,10.0
2020-08-31 00:00:00+00:00,Rheinland-Pfalz,40,56,392,9129,10.0
2020-09-01 00:00:00+00:00,Rheinland-Pfalz,48,55,388,9177,9.0
2020-09-02 00:00:00+00:00,Rheinland-Pfalz,35,51,362,9212,9.0
2020-09-03 00:00:00+00:00,Rheinland-Pfalz,57,52,365,9269,9.0
2020-09-04 00:00:00+00:00,Rheinland-Pfalz,53,46,322,9322,8.0
2020-09-05 00:00:00+00:00,Rheinland-Pfalz,47,43,305,9369,7.0
2020-09-06 00:00:00+00:00,Rheinland-Pfalz,28,44,308,9397,8.0
2020-09-07 00:00:00+00:00,Rheinland-Pfalz,70,48,338,9467,8.0
2020-09-08 00:00:00+00:00,Rheinland-Pfalz,52,48,342,9519,8.0
2020-09-09 00:00:00+00:00,Rheinland-Pfalz,59,52,366,9578,9.0
2020-09-10 00:00:00+00:00,Rheinland-Pfalz,56,52,365,9634,9.0
2020-09-11 00:00:00+00:00,Rheinland-Pfalz,82,56,394,9716,10.0
2020-09-12 00:00:00+00:00,Rheinland-Pfalz,54,57,401,9770,10.0
2020-09-13 00:00:00+00:00,Rheinland-Pfalz,9,54,382,9779,9.0
2020-09-14 00:00:00+00:00,Rheinland-Pfalz,50,51,362,9829,9.0
2020-09-15 00:00:00+00:00,Rheinland-Pfalz,50,51,360,9879,9.0
2020-09-16 00:00:00+00:00,Rheinland-Pfalz,81,54,382,9960,9.0
2020-09-17 00:00:00+00:00,Rheinland-Pfalz,60,55,386,10020,9.0
2020-09-18 00:00:00+00:00,Rheinland-Pfalz,73,53,377,10093,9.0
2020-09-19 00:00:00+00:00,Rheinland-Pfalz,45,52,368,10138,9.0
2020-09-20 00:00:00+00:00,Rheinland-Pfalz,9,52,368,10147,9.0
2020-09-21 00:00:00+00:00,Rheinland-Pfalz,62,54,380,10209,9.0
2020-09-22 00:00:00+00:00,Rheinland-Pfalz,48,54,378,10257,9.0
2020-09-23 00:00:00+00:00,Rheinland-Pfalz,67,52,364,10324,9.0
2020-09-24 00:00:00+00:00,Rheinland-Pfalz,95,57,399,10419,10.0
2020-09-25 00:00:00+00:00,Rheinland-Pfalz,84,58,410,10503,10.0
2020-09-26 00:00:00+00:00,Rheinland-Pfalz,64,61,429,10567,10.0
2020-09-27 00:00:00+00:00,Rheinland-Pfalz,39,65,459,10606,11.0
2020-09-28 00:00:00+00:00,Rheinland-Pfalz,67,66,464,10673,11.0
2020-09-29 00:00:00+00:00,Rheinland-Pfalz,64,68,480,10737,12.0
2020-09-30 00:00:00+00:00,Rheinland-Pfalz,107,74,520,10844,13.0
2020-10-01 00:00:00+00:00,Rheinland-Pfalz,121,78,546,10965,13.0
2020-10-02 00:00:00+00:00,Rheinland-Pfalz,106,81,568,11071,14.0
2020-10-03 00:00:00+00:00,Rheinland-Pfalz,83,83,587,11154,14.0
2020-10-04 00:00:00+00:00,Rheinland-Pfalz,42,84,590,11196,14.0
2020-10-05 00:00:00+00:00,Rheinland-Pfalz,105,89,628,11301,15.0
2020-10-06 00:00:00+00:00,Rheinland-Pfalz,106,95,670,11407,16.0
2020-10-07 00:00:00+00:00,Rheinland-Pfalz,173,105,736,11580,18.0
2020-10-08 00:00:00+00:00,Rheinland-Pfalz,207,117,822,11787,20.0
2020-10-09 00:00:00+00:00,Rheinland-Pfalz,152,124,868,11939,21.0
2020-10-10 00:00:00+00:00,Rheinland-Pfalz,163,135,948,12102,23.0
2020-10-11 00:00:00+00:00,Rheinland-Pfalz,104,144,1010,12206,25.0
2020-10-12 00:00:00+00:00,Rheinland-Pfalz,143,149,1048,12349,26.0
2020-10-13 00:00:00+00:00,Rheinland-Pfalz,230,167,1172,12579,29.0
2020-10-14 00:00:00+00:00,Rheinland-Pfalz,212,173,1211,12791,30.0
2020-10-15 00:00:00+00:00,Rheinland-Pfalz,344,192,1348,13135,33.0
2020-10-16 00:00:00+00:00,Rheinland-Pfalz,316,216,1512,13451,37.0
2020-10-17 00:00:00+00:00,Rheinland-Pfalz,304,236,1653,13755,40.0
2020-10-18 00:00:00+00:00,Rheinland-Pfalz,132,240,1681,13887,41.0
2020-10-19 00:00:00+00:00,Rheinland-Pfalz,257,256,1795,14144,44.0
2020-10-20 00:00:00+00:00,Rheinland-Pfalz,367,276,1932,14511,47.0
2020-10-21 00:00:00+00:00,Rheinland-Pfalz,532,321,2252,15043,55.0
2020-10-22 00:00:00+00:00,Rheinland-Pfalz,554,351,2462,15597,60.0
2020-10-23 00:00:00+00:00,Rheinland-Pfalz,551,385,2697,16148,66.0
2020-10-24 00:00:00+00:00,Rheinland-Pfalz,464,408,2857,16612,70.0
2020-10-25 00:00:00+00:00,Rheinland-Pfalz,310,433,3035,16922,74.0
2020-10-26 00:00:00+00:00,Rheinland-Pfalz,460,462,3238,17382,79.0
2020-10-27 00:00:00+00:00,Rheinland-Pfalz,725,513,3596,18107,88.0
2020-10-28 00:00:00+00:00,Rheinland-Pfalz,708,538,3772,18815,92.0
2020-10-29 00:00:00+00:00,Rheinland-Pfalz,811,575,4029,19626,98.0
2020-10-30 00:00:00+00:00,Rheinland-Pfalz,929,629,4407,20555,108.0
2020-10-31 00:00:00+00:00,Rheinland-Pfalz,467,630,4410,21022,108.0
2020-11-01 00:00:00+00:00,Rheinland-Pfalz,500,657,4600,21522,112.0
2020-11-02 00:00:00+00:00,Rheinland-Pfalz,567,672,4707,22089,115.0
2020-11-03 00:00:00+00:00,Rheinland-Pfalz,792,682,4774,22881,117.0
2020-11-04 00:00:00+00:00,Rheinland-Pfalz,869,705,4935,23750,121.0
2020-11-05 00:00:00+00:00,Rheinland-Pfalz,872,713,4996,24622,122.0
2020-11-06 00:00:00+00:00,Rheinland-Pfalz,1146,744,5213,25768,127.0
2020-11-07 00:00:00+00:00,Rheinland-Pfalz,595,763,5341,26363,130.0
2020-11-08 00:00:00+00:00,Rheinland-Pfalz,547,769,5388,26910,132.0
2020-11-09 00:00:00+00:00,Rheinland-Pfalz,629,778,5450,27539,133.0
2020-11-10 00:00:00+00:00,Rheinland-Pfalz,891,792,5549,28430,136.0
2020-11-11 00:00:00+00:00,Rheinland-Pfalz,1123,829,5803,29553,142.0
2020-11-12 00:00:00+00:00,Rheinland-Pfalz,1184,873,6115,30737,149.0
2020-11-13 00:00:00+00:00,Rheinland-Pfalz,1120,869,6089,31857,149.0
2020-11-14 00:00:00+00:00,Rheinland-Pfalz,665,879,6159,32522,150.0
2020-11-15 00:00:00+00:00,Rheinland-Pfalz,490,871,6102,33012,149.0
2020-11-16 00:00:00+00:00,Rheinland-Pfalz,692,880,6165,33704,151.0
2020-11-17 00:00:00+00:00,Rheinland-Pfalz,745,859,6019,34449,147.0
2020-11-18 00:00:00+00:00,Rheinland-Pfalz,998,842,5894,35447,144.0
2020-11-19 00:00:00+00:00,Rheinland-Pfalz,950,808,5660,36397,138.0
2020-11-20 00:00:00+00:00,Rheinland-Pfalz,1136,810,5676,37533,139.0
2020-11-21 00:00:00+00:00,Rheinland-Pfalz,713,817,5724,38246,140.0
2020-11-22 00:00:00+00:00,Rheinland-Pfalz,529,823,5763,38775,141.0
2020-11-23 00:00:00+00:00,Rheinland-Pfalz,588,808,5659,39363,138.0
2020-11-24 00:00:00+00:00,Rheinland-Pfalz,816,818,5730,40179,140.0
2020-11-25 00:00:00+00:00,Rheinland-Pfalz,884,802,5616,41063,137.0
2020-11-26 00:00:00+00:00,Rheinland-Pfalz,961,803,5627,42024,137.0
2020-11-27 00:00:00+00:00,Rheinland-Pfalz,789,754,5280,42813,129.0
2020-11-28 00:00:00+00:00,Rheinland-Pfalz,707,753,5274,43520,129.0
2020-11-29 00:00:00+00:00,Rheinland-Pfalz,400,735,5145,43920,126.0
2020-11-30 00:00:00+00:00,Rheinland-Pfalz,650,743,5207,44570,127.0
2020-12-01 00:00:00+00:00,Rheinland-Pfalz,838,747,5229,45408,128.0
2020-12-02 00:00:00+00:00,Rheinland-Pfalz,978,760,5323,46386,130.0
2020-12-03 00:00:00+00:00,Rheinland-Pfalz,1091,779,5453,47477,133.0
2020-12-04 00:00:00+00:00,Rheinland-Pfalz,1105,824,5769,48582,141.0
2020-12-05 00:00:00+00:00,Rheinland-Pfalz,755,831,5817,49337,142.0
2020-12-06 00:00:00+00:00,Rheinland-Pfalz,424,834,5841,49761,143.0
2020-12-07 00:00:00+00:00,Rheinland-Pfalz,766,851,5957,50527,146.0
2020-12-08 00:00:00+00:00,Rheinland-Pfalz,849,852,5968,51376,146.0
2020-12-09 00:00:00+00:00,Rheinland-Pfalz,1199,884,6189,52575,151.0
2020-12-10 00:00:00+00:00,Rheinland-Pfalz,1332,918,6430,53907,157.0
2020-12-11 00:00:00+00:00,Rheinland-Pfalz,1278,943,6603,55185,161.0
2020-12-12 00:00:00+00:00,Rheinland-Pfalz,888,962,6736,56073,165.0
2020-12-13 00:00:00+00:00,Rheinland-Pfalz,574,983,6886,56647,168.0
2020-12-14 00:00:00+00:00,Rheinland-Pfalz,857,996,6977,57504,170.0
2020-12-15 00:00:00+00:00,Rheinland-Pfalz,1103,1033,7231,58607,177.0
2020-12-16 00:00:00+00:00,Rheinland-Pfalz,1297,1047,7329,59904,179.0
2020-12-17 00:00:00+00:00,Rheinland-Pfalz,1266,1037,7263,61170,177.0
2020-12-18 00:00:00+00:00,Rheinland-Pfalz,1236,1031,7221,62406,176.0
2020-12-19 00:00:00+00:00,Rheinland-Pfalz,729,1008,7062,63135,173.0
2020-12-20 00:00:00+00:00,Rheinland-Pfalz,912,1057,7400,64047,181.0
2020-12-21 00:00:00+00:00,Rheinland-Pfalz,861,1057,7404,64908,181.0
2020-12-22 00:00:00+00:00,Rheinland-Pfalz,1019,1045,7320,65927,179.0
2020-12-23 00:00:00+00:00,Rheinland-Pfalz,1481,1072,7504,67408,183.0
2020-12-24 00:00:00+00:00,Rheinland-Pfalz,643,983,6881,68051,168.0
2020-12-25 00:00:00+00:00,Rheinland-Pfalz,569,887,6214,68620,152.0
2020-12-26 00:00:00+00:00,Rheinland-Pfalz,375,837,5860,68995,143.0
2020-12-27 00:00:00+00:00,Rheinland-Pfalz,520,781,5468,69515,134.0
2020-12-28 00:00:00+00:00,Rheinland-Pfalz,649,750,5256,70164,128.0
2020-12-29 00:00:00+00:00,Rheinland-Pfalz,1116,764,5353,71280,131.0
2020-12-30 00:00:00+00:00,Rheinland-Pfalz,1199,724,5071,72479,124.0
2020-12-31 00:00:00+00:00,Rheinland-Pfalz,767,742,5195,73246,127.0
2021-01-01 00:00:00+00:00,Rheinland-Pfalz,436,723,5062,73682,124.0
2021-01-02 00:00:00+00:00,Rheinland-Pfalz,610,756,5297,74292,129.0
2021-01-03 00:00:00+00:00,Rheinland-Pfalz,358,733,5135,74650,125.0
2021-01-04 00:00:00+00:00,Rheinland-Pfalz,528,716,5014,75178,122.0
2021-01-05 00:00:00+00:00,Rheinland-Pfalz,1005,700,4903,76183,120.0
2021-01-06 00:00:00+00:00,Rheinland-Pfalz,1140,692,4844,77323,118.0
2021-01-07 00:00:00+00:00,Rheinland-Pfalz,1134,744,5211,78457,127.0
2021-01-08 00:00:00+00:00,Rheinland-Pfalz,965,820,5740,79422,140.0
2021-01-09 00:00:00+00:00,Rheinland-Pfalz,705,833,5835,80127,143.0
2021-01-10 00:00:00+00:00,Rheinland-Pfalz,392,838,5869,80519,143.0
2021-01-11 00:00:00+00:00,Rheinland-Pfalz,535,839,5876,81054,144.0
2021-01-12 00:00:00+00:00,Rheinland-Pfalz,811,811,5682,81865,139.0
2021-01-13 00:00:00+00:00,Rheinland-Pfalz,897,777,5439,82762,133.0
2021-01-14 00:00:00+00:00,Rheinland-Pfalz,877,740,5182,83639,127.0
2021-01-15 00:00:00+00:00,Rheinland-Pfalz,715,704,4932,84354,120.0
2021-01-16 00:00:00+00:00,Rheinland-Pfalz,568,685,4795,84922,117.0
2021-01-17 00:00:00+00:00,Rheinland-Pfalz,331,676,4734,85253,116.0
2021-01-18 00:00:00+00:00,Rheinland-Pfalz,353,650,4552,85606,111.0
2021-01-19 00:00:00+00:00,Rheinland-Pfalz,717,636,4458,86323,109.0
2021-01-20 00:00:00+00:00,Rheinland-Pfalz,969,647,4530,87292,111.0
2021-01-21 00:00:00+00:00,Rheinland-Pfalz,764,631,4417,88056,108.0
2021-01-22 00:00:00+00:00,Rheinland-Pfalz,762,637,4464,88818,109.0
2021-01-23 00:00:00+00:00,Rheinland-Pfalz,484,625,4380,89302,107.0
2021-01-24 00:00:00+00:00,Rheinland-Pfalz,252,614,4301,89554,105.0
2021-01-25 00:00:00+00:00,Rheinland-Pfalz,334,611,4282,89888,105.0
2021-01-26 00:00:00+00:00,Rheinland-Pfalz,698,609,4263,90586,104.0
2021-01-27 00:00:00+00:00,Rheinland-Pfalz,688,568,3982,91274,97.0
2021-01-28 00:00:00+00:00,Rheinland-Pfalz,606,546,3824,91880,93.0
2021-01-29 00:00:00+00:00,Rheinland-Pfalz,517,511,3579,92397,87.0
2021-01-30 00:00:00+00:00,Rheinland-Pfalz,414,501,3509,92811,86.0
2021-01-31 00:00:00+00:00,Rheinland-Pfalz,252,501,3509,93063,86.0
2021-02-01 00:00:00+00:00,Rheinland-Pfalz,252,489,3427,93315,84.0
2021-02-02 00:00:00+00:00,Rheinland-Pfalz,522,464,3251,93837,79.0
2021-02-03 00:00:00+00:00,Rheinland-Pfalz,496,437,3059,94333,75.0
2021-02-04 00:00:00+00:00,Rheinland-Pfalz,494,421,2947,94827,72.0
2021-02-05 00:00:00+00:00,Rheinland-Pfalz,441,410,2871,95268,70.0
2021-02-06 00:00:00+00:00,Rheinland-Pfalz,300,393,2757,95568,67.0
2021-02-07 00:00:00+00:00,Rheinland-Pfalz,174,382,2679,95742,65.0
2021-02-08 00:00:00+00:00,Rheinland-Pfalz,231,379,2658,95973,65.0
2021-02-09 00:00:00+00:00,Rheinland-Pfalz,404,362,2540,96377,62.0
2021-02-10 00:00:00+00:00,Rheinland-Pfalz,364,344,2408,96741,59.0
2021-02-11 00:00:00+00:00,Rheinland-Pfalz,375,327,2289,97116,56.0
2021-02-12 00:00:00+00:00,Rheinland-Pfalz,317,309,2165,97433,53.0
2021-02-13 00:00:00+00:00,Rheinland-Pfalz,221,298,2086,97654,51.0
2021-02-14 00:00:00+00:00,Rheinland-Pfalz,208,302,2120,97862,52.0
2021-02-15 00:00:00+00:00,Rheinland-Pfalz,176,295,2065,98038,50.0
2021-02-16 00:00:00+00:00,Rheinland-Pfalz,347,286,2008,98385,49.0
2021-02-17 00:00:00+00:00,Rheinland-Pfalz,370,287,2014,98755,49.0
2021-02-18 00:00:00+00:00,Rheinland-Pfalz,397,290,2036,99152,50.0
2021-02-19 00:00:00+00:00,Rheinland-Pfalz,356,296,2075,99508,51.0
2021-02-20 00:00:00+00:00,Rheinland-Pfalz,386,320,2240,99894,55.0
2021-02-21 00:00:00+00:00,Rheinland-Pfalz,216,321,2248,100110,55.0
2021-02-22 00:00:00+00:00,Rheinland-Pfalz,180,321,2252,100290,55.0
2021-02-23 00:00:00+00:00,Rheinland-Pfalz,330,319,2235,100620,55.0
2021-02-24 00:00:00+00:00,Rheinland-Pfalz,405,324,2270,101025,55.0
2021-02-25 00:00:00+00:00,Rheinland-Pfalz,431,329,2304,101456,56.0
2021-02-26 00:00:00+00:00,Rheinland-Pfalz,346,327,2294,101802,56.0
2021-02-27 00:00:00+00:00,Rheinland-Pfalz,307,316,2215,102109,54.0
2021-02-28 00:00:00+00:00,Rheinland-Pfalz,110,301,2109,102219,52.0
2021-03-01 00:00:00+00:00,Rheinland-Pfalz,186,302,2115,102405,52.0
2021-03-02 00:00:00+00:00,Rheinland-Pfalz,321,300,2106,102726,51.0
2021-03-03 00:00:00+00:00,Rheinland-Pfalz,406,301,2107,103132,51.0
2021-03-04 00:00:00+00:00,Rheinland-Pfalz,368,292,2044,103500,50.0
2021-03-05 00:00:00+00:00,Rheinland-Pfalz,333,290,2031,103833,50.0
2021-03-06 00:00:00+00:00,Rheinland-Pfalz,256,282,1980,104089,48.0
2021-03-07 00:00:00+00:00,Rheinland-Pfalz,169,291,2039,104258,50.0
2021-03-08 00:00:00+00:00,Rheinland-Pfalz,146,285,1999,104404,49.0
2021-03-09 00:00:00+00:00,Rheinland-Pfalz,375,293,2053,104779,50.0
2021-03-10 00:00:00+00:00,Rheinland-Pfalz,471,302,2118,105250,52.0
2021-03-11 00:00:00+00:00,Rheinland-Pfalz,472,317,2222,105722,54.0
2021-03-12 00:00:00+00:00,Rheinland-Pfalz,419,329,2308,106141,56.0
2021-03-13 00:00:00+00:00,Rheinland-Pfalz,340,341,2392,106481,58.0
2021-03-14 00:00:00+00:00,Rheinland-Pfalz,270,356,2493,106751,61.0
2021-03-15 00:00:00+00:00,Rheinland-Pfalz,261,372,2608,107012,64.0
2021-03-16 00:00:00+00:00,Rheinland-Pfalz,528,394,2761,107540,67.0
2021-03-17 00:00:00+00:00,Rheinland-Pfalz,659,421,2949,108199,72.0
2021-03-18 00:00:00+00:00,Rheinland-Pfalz,543,431,3020,108742,74.0
2021-03-19 00:00:00+00:00,Rheinland-Pfalz,625,460,3226,109367,79.0
2021-03-20 00:00:00+00:00,Rheinland-Pfalz,478,480,3364,109845,82.0
2021-03-21 00:00:00+00:00,Rheinland-Pfalz,316,487,3410,110161,83.0
2021-03-22 00:00:00+00:00,Rheinland-Pfalz,339,498,3488,110500,85.0
2021-03-23 00:00:00+00:00,Rheinland-Pfalz,594,507,3554,111094,87.0
2021-03-24 00:00:00+00:00,Rheinland-Pfalz,895,541,3790,111989,93.0
2021-03-25 00:00:00+00:00,Rheinland-Pfalz,921,595,4168,112910,102.0
2021-03-26 00:00:00+00:00,Rheinland-Pfalz,809,621,4352,113719,106.0
2021-03-27 00:00:00+00:00,Rheinland-Pfalz,723,656,4597,114442,112.0
2021-03-28 00:00:00+00:00,Rheinland-Pfalz,372,664,4653,114814,114.0
2021-03-29 00:00:00+00:00,Rheinland-Pfalz,512,689,4826,115326,118.0
2021-03-30 00:00:00+00:00,Rheinland-Pfalz,710,706,4942,116036,121.0
2021-03-31 00:00:00+00:00,Rheinland-Pfalz,984,718,5031,117020,123.0
2021-04-01 00:00:00+00:00,Rheinland-Pfalz,926,719,5036,117946,123.0
2021-04-02 00:00:00+00:00,Rheinland-Pfalz,595,688,4822,118541,118.0
2021-04-03 00:00:00+00:00,Rheinland-Pfalz,599,671,4698,119140,115.0
2021-04-04 00:00:00+00:00,Rheinland-Pfalz,344,667,4670,119484,114.0
2021-04-05 00:00:00+00:00,Rheinland-Pfalz,279,633,4437,119763,108.0
2021-04-06 00:00:00+00:00,Rheinland-Pfalz,386,587,4113,120149,100.0
2021-04-07 00:00:00+00:00,Rheinland-Pfalz,914,577,4043,121063,99.0
2021-04-08 00:00:00+00:00,Rheinland-Pfalz,1072,598,4189,122135,102.0
2021-04-09 00:00:00+00:00,Rheinland-Pfalz,827,631,4421,122962,108.0
2021-04-10 00:00:00+00:00,Rheinland-Pfalz,695,645,4517,123657,110.0
2021-04-11 00:00:00+00:00,Rheinland-Pfalz,607,682,4780,124264,117.0
2021-04-12 00:00:00+00:00,Rheinland-Pfalz,502,714,5003,124766,122.0
2021-04-13 00:00:00+00:00,Rheinland-Pfalz,994,801,5611,125760,137.0
2021-04-14 00:00:00+00:00,Rheinland-Pfalz,1116,830,5813,126876,142.0
2021-04-15 00:00:00+00:00,Rheinland-Pfalz,1068,829,5809,127944,142.0
2021-04-16 00:00:00+00:00,Rheinland-Pfalz,1167,878,6149,129111,150.0
2021-04-17 00:00:00+00:00,Rheinland-Pfalz,683,876,6137,129794,150.0
2021-04-18 00:00:00+00:00,Rheinland-Pfalz,432,851,5962,130226,146.0
2021-04-19 00:00:00+00:00,Rheinland-Pfalz,625,869,6085,130851,149.0
2021-04-20 00:00:00+00:00,Rheinland-Pfalz,1021,873,6112,131872,149.0
2021-04-21 00:00:00+00:00,Rheinland-Pfalz,1152,878,6148,133024,150.0
2021-04-22 00:00:00+00:00,Rheinland-Pfalz,1086,880,6166,134110,151.0
2021-04-23 00:00:00+00:00,Rheinland-Pfalz,1061,865,6060,135171,148.0
2021-04-24 00:00:00+00:00,Rheinland-Pfalz,780,879,6157,135951,150.0
2021-04-25 00:00:00+00:00,Rheinland-Pfalz,362,869,6087,136313,149.0
2021-04-26 00:00:00+00:00,Rheinland-Pfalz,551,859,6013,136864,147.0
2021-04-27 00:00:00+00:00,Rheinland-Pfalz,834,832,5826,137698,142.0
2021-04-28 00:00:00+00:00,Rheinland-Pfalz,1207,840,5881,138905,144.0
2021-04-29 00:00:00+00:00,Rheinland-Pfalz,957,821,5752,139862,141.0
2021-04-30 00:00:00+00:00,Rheinland-Pfalz,692,769,5383,140554,131.0
2021-05-01 00:00:00+00:00,Rheinland-Pfalz,666,752,5269,141220,129.0
2021-05-02 00:00:00+00:00,Rheinland-Pfalz,372,754,5279,141592,129.0
2021-05-03 00:00:00+00:00,Rheinland-Pfalz,423,735,5151,142015,126.0
2021-05-04 00:00:00+00:00,Rheinland-Pfalz,725,720,5042,142740,123.0
2021-05-05 00:00:00+00:00,Rheinland-Pfalz,808,663,4643,143548,113.0
2021-05-06 00:00:00+00:00,Rheinland-Pfalz,762,635,4448,144310,109.0
2021-05-07 00:00:00+00:00,Rheinland-Pfalz,639,627,4395,144949,107.0
2021-05-08 00:00:00+00:00,Rheinland-Pfalz,539,609,4268,145488,104.0
2021-05-09 00:00:00+00:00,Rheinland-Pfalz,268,594,4164,145756,102.0
2021-05-10 00:00:00+00:00,Rheinland-Pfalz,350,584,4091,146106,100.0
2021-05-11 00:00:00+00:00,Rheinland-Pfalz,722,584,4088,146828,100.0
2021-05-12 00:00:00+00:00,Rheinland-Pfalz,735,573,4015,147563,98.0
2021-05-13 00:00:00+00:00,Rheinland-Pfalz,393,520,3646,147956,89.0
2021-05-14 00:00:00+00:00,Rheinland-Pfalz,435,491,3442,148391,84.0
2021-05-15 00:00:00+00:00,Rheinland-Pfalz,415,474,3318,148806,81.0
2021-05-16 00:00:00+00:00,Rheinland-Pfalz,220,467,3270,149026,80.0
2021-05-17 00:00:00+00:00,Rheinland-Pfalz,198,445,3118,149224,76.0
2021-05-18 00:00:00+00:00,Rheinland-Pfalz,503,414,2899,149727,71.0
2021-05-19 00:00:00+00:00,Rheinland-Pfalz,489,379,2653,150216,65.0
2021-05-20 00:00:00+00:00,Rheinland-Pfalz,411,381,2671,150627,65.0
2021-05-21 00:00:00+00:00,Rheinland-Pfalz,369,372,2605,150996,64.0
2021-05-22 00:00:00+00:00,Rheinland-Pfalz,219,344,2409,151215,59.0
2021-05-23 00:00:00+00:00,Rheinland-Pfalz,134,331,2323,151349,57.0
2021-05-24 00:00:00+00:00,Rheinland-Pfalz,100,317,2225,151449,54.0
2021-05-25 00:00:00+00:00,Rheinland-Pfalz,178,271,1900,151627,46.0
2021-05-26 00:00:00+00:00,Rheinland-Pfalz,280,241,1691,151907,41.0
2021-05-27 00:00:00+00:00,Rheinland-Pfalz,275,222,1555,152182,38.0
2021-05-28 00:00:00+00:00,Rheinland-Pfalz,227,201,1413,152409,35.0
2021-05-29 00:00:00+00:00,Rheinland-Pfalz,183,196,1377,152592,34.0
2021-05-30 00:00:00+00:00,Rheinland-Pfalz,119,194,1362,152711,33.0
2021-05-31 00:00:00+00:00,Rheinland-Pfalz,112,196,1374,152823,34.0
2021-06-01 00:00:00+00:00,Rheinland-Pfalz,217,201,1413,153040,35.0
2021-06-02 00:00:00+00:00,Rheinland-Pfalz,256,198,1389,153296,34.0
2021-06-03 00:00:00+00:00,Rheinland-Pfalz,142,179,1256,153438,31.0
2021-06-04 00:00:00+00:00,Rheinland-Pfalz,138,166,1167,153576,29.0
2021-06-05 00:00:00+00:00,Rheinland-Pfalz,124,158,1108,153700,27.0
2021-06-06 00:00:00+00:00,Rheinland-Pfalz,57,149,1046,153757,26.0
2021-06-07 00:00:00+00:00,Rheinland-Pfalz,103,148,1037,153860,25.0
2021-06-08 00:00:00+00:00,Rheinland-Pfalz,139,137,959,153999,23.0
2021-06-09 00:00:00+00:00,Rheinland-Pfalz,170,124,873,154169,21.0
2021-06-10 00:00:00+00:00,Rheinland-Pfalz,123,122,854,154292,21.0
2021-06-11 00:00:00+00:00,Rheinland-Pfalz,95,115,811,154387,20.0
2021-06-12 00:00:00+00:00,Rheinland-Pfalz,55,106,742,154442,18.0
2021-06-13 00:00:00+00:00,Rheinland-Pfalz,36,103,721,154478,18.0
2021-06-14 00:00:00+00:00,Rheinland-Pfalz,58,96,676,154536,17.0
2021-06-15 00:00:00+00:00,Rheinland-Pfalz,87,89,624,154623,15.0
2021-06-16 00:00:00+00:00,Rheinland-Pfalz,80,76,534,154703,13.0
2021-06-17 00:00:00+00:00,Rheinland-Pfalz,66,68,477,154769,12.0
2021-06-18 00:00:00+00:00,Rheinland-Pfalz,55,62,437,154824,11.0
2021-06-19 00:00:00+00:00,Rheinland-Pfalz,29,58,411,154853,10.0
2021-06-20 00:00:00+00:00,Rheinland-Pfalz,22,56,397,154875,10.0
2021-06-21 00:00:00+00:00,Rheinland-Pfalz,21,51,360,154896,9.0
2021-06-22 00:00:00+00:00,Rheinland-Pfalz,52,46,325,154948,8.0
2021-06-23 00:00:00+00:00,Rheinland-Pfalz,57,43,302,155005,7.0
2021-06-24 00:00:00+00:00,Rheinland-Pfalz,40,39,276,155045,7.0
2021-06-25 00:00:00+00:00,Rheinland-Pfalz,24,35,245,155069,6.0
2021-06-26 00:00:00+00:00,Rheinland-Pfalz,16,33,232,155085,6.0
2021-06-27 00:00:00+00:00,Rheinland-Pfalz,21,33,231,155106,6.0
2021-06-28 00:00:00+00:00,Rheinland-Pfalz,26,33,236,155132,6.0
2021-06-29 00:00:00+00:00,Rheinland-Pfalz,38,31,222,155170,5.0
2021-06-30 00:00:00+00:00,Rheinland-Pfalz,48,30,213,155218,5.0
2021-07-01 00:00:00+00:00,Rheinland-Pfalz,44,31,217,155262,5.0
2021-07-02 00:00:00+00:00,Rheinland-Pfalz,39,33,232,155301,6.0
2021-07-03 00:00:00+00:00,Rheinland-Pfalz,25,34,241,155326,6.0
2021-07-04 00:00:00+00:00,Rheinland-Pfalz,6,32,226,155332,6.0
2021-07-05 00:00:00+00:00,Rheinland-Pfalz,31,33,231,155363,6.0
2021-07-06 00:00:00+00:00,Rheinland-Pfalz,60,36,253,155423,6.0
2020-02-28 00:00:00+00:00,Schleswig-Holstein,1,0,0,1,0.0
2020-02-29 00:00:00+00:00,Schleswig-Holstein,1,0,0,2,0.0
2020-03-02 00:00:00+00:00,Schleswig-Holstein,2,0,0,4,0.0
2020-03-03 00:00:00+00:00,Schleswig-Holstein,1,0,0,5,0.0
2020-03-05 00:00:00+00:00,Schleswig-Holstein,1,0,0,6,0.0
2020-03-06 00:00:00+00:00,Schleswig-Holstein,2,0,0,8,0.0
2020-03-08 00:00:00+00:00,Schleswig-Holstein,1,1,9,9,0.0
2020-03-09 00:00:00+00:00,Schleswig-Holstein,3,1,11,12,0.0
2020-03-10 00:00:00+00:00,Schleswig-Holstein,7,2,17,19,1.0
2020-03-11 00:00:00+00:00,Schleswig-Holstein,19,4,34,38,1.0
2020-03-12 00:00:00+00:00,Schleswig-Holstein,18,7,51,56,2.0
2020-03-13 00:00:00+00:00,Schleswig-Holstein,27,11,77,83,3.0
2020-03-14 00:00:00+00:00,Schleswig-Holstein,24,14,99,107,3.0
2020-03-15 00:00:00+00:00,Schleswig-Holstein,21,17,119,128,4.0
2020-03-16 00:00:00+00:00,Schleswig-Holstein,29,20,145,157,5.0
2020-03-17 00:00:00+00:00,Schleswig-Holstein,46,26,184,203,6.0
2020-03-18 00:00:00+00:00,Schleswig-Holstein,53,31,218,256,8.0
2020-03-19 00:00:00+00:00,Schleswig-Holstein,60,37,260,316,9.0
2020-03-20 00:00:00+00:00,Schleswig-Holstein,78,44,311,394,11.0
2020-03-21 00:00:00+00:00,Schleswig-Holstein,45,47,332,439,11.0
2020-03-22 00:00:00+00:00,Schleswig-Holstein,34,49,345,473,12.0
2020-03-23 00:00:00+00:00,Schleswig-Holstein,94,58,410,567,14.0
2020-03-24 00:00:00+00:00,Schleswig-Holstein,100,66,464,667,16.0
2020-03-25 00:00:00+00:00,Schleswig-Holstein,86,71,497,753,17.0
2020-03-26 00:00:00+00:00,Schleswig-Holstein,96,76,533,849,18.0
2020-03-27 00:00:00+00:00,Schleswig-Holstein,117,81,572,966,20.0
2020-03-28 00:00:00+00:00,Schleswig-Holstein,82,87,609,1048,21.0
2020-03-29 00:00:00+00:00,Schleswig-Holstein,43,88,618,1091,21.0
2020-03-30 00:00:00+00:00,Schleswig-Holstein,78,86,602,1169,21.0
2020-03-31 00:00:00+00:00,Schleswig-Holstein,104,86,606,1273,21.0
2020-04-01 00:00:00+00:00,Schleswig-Holstein,102,88,622,1375,21.0
2020-04-02 00:00:00+00:00,Schleswig-Holstein,112,91,638,1487,22.0
2020-04-03 00:00:00+00:00,Schleswig-Holstein,112,90,633,1599,22.0
2020-04-04 00:00:00+00:00,Schleswig-Holstein,69,88,620,1668,21.0
2020-04-05 00:00:00+00:00,Schleswig-Holstein,36,87,613,1704,21.0
2020-04-06 00:00:00+00:00,Schleswig-Holstein,61,85,596,1765,21.0
2020-04-07 00:00:00+00:00,Schleswig-Holstein,112,86,604,1877,21.0
2020-04-08 00:00:00+00:00,Schleswig-Holstein,90,84,592,1967,20.0
2020-04-09 00:00:00+00:00,Schleswig-Holstein,92,81,572,2059,20.0
2020-04-10 00:00:00+00:00,Schleswig-Holstein,34,70,494,2093,17.0
2020-04-11 00:00:00+00:00,Schleswig-Holstein,40,66,465,2133,16.0
2020-04-12 00:00:00+00:00,Schleswig-Holstein,16,63,445,2149,15.0
2020-04-13 00:00:00+00:00,Schleswig-Holstein,98,68,482,2247,17.0
2020-04-14 00:00:00+00:00,Schleswig-Holstein,18,55,388,2265,13.0
2020-04-15 00:00:00+00:00,Schleswig-Holstein,42,48,340,2307,12.0
2020-04-16 00:00:00+00:00,Schleswig-Holstein,51,42,299,2358,10.0
2020-04-17 00:00:00+00:00,Schleswig-Holstein,40,43,305,2398,11.0
2020-04-18 00:00:00+00:00,Schleswig-Holstein,25,41,290,2423,10.0
2020-04-19 00:00:00+00:00,Schleswig-Holstein,9,40,283,2432,10.0
2020-04-20 00:00:00+00:00,Schleswig-Holstein,28,30,213,2460,7.0
2020-04-21 00:00:00+00:00,Schleswig-Holstein,38,33,233,2498,8.0
2020-04-22 00:00:00+00:00,Schleswig-Holstein,35,32,226,2533,8.0
2020-04-23 00:00:00+00:00,Schleswig-Holstein,41,30,216,2574,7.0
2020-04-24 00:00:00+00:00,Schleswig-Holstein,39,30,215,2613,7.0
2020-04-25 00:00:00+00:00,Schleswig-Holstein,16,29,206,2629,7.0
2020-04-26 00:00:00+00:00,Schleswig-Holstein,6,29,203,2635,7.0
2020-04-27 00:00:00+00:00,Schleswig-Holstein,13,26,188,2648,6.0
2020-04-28 00:00:00+00:00,Schleswig-Holstein,22,24,172,2670,6.0
2020-04-29 00:00:00+00:00,Schleswig-Holstein,18,22,155,2688,5.0
2020-04-30 00:00:00+00:00,Schleswig-Holstein,19,19,133,2707,5.0
2020-05-01 00:00:00+00:00,Schleswig-Holstein,13,15,107,2720,4.0
2020-05-02 00:00:00+00:00,Schleswig-Holstein,11,14,102,2731,4.0
2020-05-03 00:00:00+00:00,Schleswig-Holstein,49,20,145,2780,5.0
2020-05-04 00:00:00+00:00,Schleswig-Holstein,15,21,147,2795,5.0
2020-05-05 00:00:00+00:00,Schleswig-Holstein,49,24,174,2844,6.0
2020-05-06 00:00:00+00:00,Schleswig-Holstein,16,24,172,2860,6.0
2020-05-07 00:00:00+00:00,Schleswig-Holstein,34,26,187,2894,6.0
2020-05-08 00:00:00+00:00,Schleswig-Holstein,22,28,196,2916,7.0
2020-05-09 00:00:00+00:00,Schleswig-Holstein,20,29,205,2936,7.0
2020-05-10 00:00:00+00:00,Schleswig-Holstein,20,25,176,2956,6.0
2020-05-11 00:00:00+00:00,Schleswig-Holstein,5,23,166,2961,6.0
2020-05-12 00:00:00+00:00,Schleswig-Holstein,16,19,133,2977,5.0
2020-05-13 00:00:00+00:00,Schleswig-Holstein,12,18,129,2989,4.0
2020-05-14 00:00:00+00:00,Schleswig-Holstein,5,14,100,2994,3.0
2020-05-15 00:00:00+00:00,Schleswig-Holstein,7,12,85,3001,3.0
2020-05-16 00:00:00+00:00,Schleswig-Holstein,2,9,67,3003,2.0
2020-05-17 00:00:00+00:00,Schleswig-Holstein,1,6,48,3004,2.0
2020-05-19 00:00:00+00:00,Schleswig-Holstein,14,8,57,3018,2.0
2020-05-20 00:00:00+00:00,Schleswig-Holstein,9,7,50,3027,2.0
2020-05-21 00:00:00+00:00,Schleswig-Holstein,23,8,61,3050,2.0
2020-05-22 00:00:00+00:00,Schleswig-Holstein,18,10,74,3068,3.0
2020-05-26 00:00:00+00:00,Schleswig-Holstein,7,10,74,3075,3.0
2020-05-28 00:00:00+00:00,Schleswig-Holstein,6,11,78,3081,3.0
2020-05-29 00:00:00+00:00,Schleswig-Holstein,14,13,91,3095,3.0
2020-05-30 00:00:00+00:00,Schleswig-Holstein,4,11,81,3099,3.0
2020-05-31 00:00:00+00:00,Schleswig-Holstein,3,10,75,3102,3.0
2020-06-01 00:00:00+00:00,Schleswig-Holstein,5,8,57,3107,2.0
2020-06-02 00:00:00+00:00,Schleswig-Holstein,1,5,40,3108,1.0
2020-06-05 00:00:00+00:00,Schleswig-Holstein,2,5,35,3110,1.0
2020-06-06 00:00:00+00:00,Schleswig-Holstein,2,4,31,3112,1.0
2020-06-07 00:00:00+00:00,Schleswig-Holstein,1,2,18,3113,1.0
2020-06-08 00:00:00+00:00,Schleswig-Holstein,2,2,16,3115,1.0
2020-06-09 00:00:00+00:00,Schleswig-Holstein,1,2,14,3116,0.0
2020-06-10 00:00:00+00:00,Schleswig-Holstein,2,1,11,3118,0.0
2020-06-11 00:00:00+00:00,Schleswig-Holstein,3,1,13,3121,0.0
2020-06-12 00:00:00+00:00,Schleswig-Holstein,1,1,12,3122,0.0
2020-06-15 00:00:00+00:00,Schleswig-Holstein,2,1,12,3124,0.0
2020-06-16 00:00:00+00:00,Schleswig-Holstein,1,1,12,3125,0.0
2020-06-18 00:00:00+00:00,Schleswig-Holstein,9,2,19,3134,1.0
2020-06-19 00:00:00+00:00,Schleswig-Holstein,2,2,20,3136,1.0
2020-06-20 00:00:00+00:00,Schleswig-Holstein,1,2,19,3137,1.0
2020-06-21 00:00:00+00:00,Schleswig-Holstein,2,2,18,3139,1.0
2020-06-23 00:00:00+00:00,Schleswig-Holstein,1,2,18,3140,1.0
2020-06-24 00:00:00+00:00,Schleswig-Holstein,4,2,20,3144,1.0
2020-06-25 00:00:00+00:00,Schleswig-Holstein,6,3,25,3150,1.0
2020-06-26 00:00:00+00:00,Schleswig-Holstein,1,2,17,3151,1.0
2020-06-27 00:00:00+00:00,Schleswig-Holstein,3,2,18,3154,1.0
2020-06-28 00:00:00+00:00,Schleswig-Holstein,1,2,18,3155,1.0
2020-06-29 00:00:00+00:00,Schleswig-Holstein,3,2,19,3158,1.0
2020-06-30 00:00:00+00:00,Schleswig-Holstein,5,3,23,3163,1.0
2020-07-01 00:00:00+00:00,Schleswig-Holstein,12,4,31,3175,1.0
2020-07-02 00:00:00+00:00,Schleswig-Holstein,5,4,30,3180,1.0
2020-07-03 00:00:00+00:00,Schleswig-Holstein,4,4,33,3184,1.0
2020-07-04 00:00:00+00:00,Schleswig-Holstein,3,4,33,3187,1.0
2020-07-05 00:00:00+00:00,Schleswig-Holstein,5,5,37,3192,1.0
2020-07-07 00:00:00+00:00,Schleswig-Holstein,4,5,38,3196,1.0
2020-07-08 00:00:00+00:00,Schleswig-Holstein,7,5,40,3203,1.0
2020-07-09 00:00:00+00:00,Schleswig-Holstein,3,4,31,3206,1.0
2020-07-10 00:00:00+00:00,Schleswig-Holstein,1,3,27,3207,1.0
2020-07-12 00:00:00+00:00,Schleswig-Holstein,8,4,31,3215,1.0
2020-07-13 00:00:00+00:00,Schleswig-Holstein,8,5,36,3223,1.0
2020-07-14 00:00:00+00:00,Schleswig-Holstein,8,5,39,3231,1.0
2020-07-15 00:00:00+00:00,Schleswig-Holstein,8,6,43,3239,1.0
2020-07-16 00:00:00+00:00,Schleswig-Holstein,2,5,38,3241,1.0
2020-07-17 00:00:00+00:00,Schleswig-Holstein,14,7,49,3255,2.0
2020-07-18 00:00:00+00:00,Schleswig-Holstein,4,7,52,3259,2.0
2020-07-19 00:00:00+00:00,Schleswig-Holstein,7,7,51,3266,2.0
2020-07-20 00:00:00+00:00,Schleswig-Holstein,9,7,52,3275,2.0
2020-07-21 00:00:00+00:00,Schleswig-Holstein,6,7,50,3281,2.0
2020-07-22 00:00:00+00:00,Schleswig-Holstein,17,8,59,3298,2.0
2020-07-23 00:00:00+00:00,Schleswig-Holstein,8,9,65,3306,2.0
2020-07-24 00:00:00+00:00,Schleswig-Holstein,12,9,63,3318,2.0
2020-07-25 00:00:00+00:00,Schleswig-Holstein,7,9,66,3325,2.0
2020-07-26 00:00:00+00:00,Schleswig-Holstein,7,9,66,3332,2.0
2020-07-27 00:00:00+00:00,Schleswig-Holstein,23,11,80,3355,3.0
2020-07-28 00:00:00+00:00,Schleswig-Holstein,26,14,100,3381,3.0
2020-07-29 00:00:00+00:00,Schleswig-Holstein,31,16,114,3412,4.0
2020-07-30 00:00:00+00:00,Schleswig-Holstein,26,18,132,3438,5.0
2020-07-31 00:00:00+00:00,Schleswig-Holstein,24,20,144,3462,5.0
2020-08-01 00:00:00+00:00,Schleswig-Holstein,16,21,153,3478,5.0
2020-08-02 00:00:00+00:00,Schleswig-Holstein,7,21,153,3485,5.0
2020-08-03 00:00:00+00:00,Schleswig-Holstein,17,21,147,3502,5.0
2020-08-04 00:00:00+00:00,Schleswig-Holstein,22,20,143,3524,5.0
2020-08-05 00:00:00+00:00,Schleswig-Holstein,17,18,129,3541,4.0
2020-08-06 00:00:00+00:00,Schleswig-Holstein,36,19,139,3577,5.0
2020-08-07 00:00:00+00:00,Schleswig-Holstein,10,17,125,3587,4.0
2020-08-08 00:00:00+00:00,Schleswig-Holstein,9,16,118,3596,4.0
2020-08-09 00:00:00+00:00,Schleswig-Holstein,8,17,119,3604,4.0
2020-08-10 00:00:00+00:00,Schleswig-Holstein,35,19,137,3639,5.0
2020-08-11 00:00:00+00:00,Schleswig-Holstein,52,23,167,3691,6.0
2020-08-12 00:00:00+00:00,Schleswig-Holstein,38,26,188,3729,6.0
2020-08-13 00:00:00+00:00,Schleswig-Holstein,22,24,174,3751,6.0
2020-08-14 00:00:00+00:00,Schleswig-Holstein,33,28,197,3784,7.0
2020-08-15 00:00:00+00:00,Schleswig-Holstein,19,29,207,3803,7.0
2020-08-16 00:00:00+00:00,Schleswig-Holstein,2,28,201,3805,7.0
2020-08-17 00:00:00+00:00,Schleswig-Holstein,15,25,181,3820,6.0
2020-08-18 00:00:00+00:00,Schleswig-Holstein,18,21,147,3838,5.0
2020-08-19 00:00:00+00:00,Schleswig-Holstein,22,18,131,3860,5.0
2020-08-20 00:00:00+00:00,Schleswig-Holstein,24,19,133,3884,5.0
2020-08-21 00:00:00+00:00,Schleswig-Holstein,14,16,114,3898,4.0
2020-08-22 00:00:00+00:00,Schleswig-Holstein,14,15,109,3912,4.0
2020-08-23 00:00:00+00:00,Schleswig-Holstein,6,16,113,3918,4.0
2020-08-24 00:00:00+00:00,Schleswig-Holstein,22,17,120,3940,4.0
2020-08-25 00:00:00+00:00,Schleswig-Holstein,28,18,130,3968,4.0
2020-08-26 00:00:00+00:00,Schleswig-Holstein,22,18,130,3990,4.0
2020-08-27 00:00:00+00:00,Schleswig-Holstein,18,17,124,4008,4.0
2020-08-28 00:00:00+00:00,Schleswig-Holstein,17,18,127,4025,4.0
2020-08-29 00:00:00+00:00,Schleswig-Holstein,5,16,118,4030,4.0
2020-08-30 00:00:00+00:00,Schleswig-Holstein,9,17,121,4039,4.0
2020-08-31 00:00:00+00:00,Schleswig-Holstein,15,16,114,4054,4.0
2020-09-01 00:00:00+00:00,Schleswig-Holstein,16,14,102,4070,4.0
2020-09-02 00:00:00+00:00,Schleswig-Holstein,26,15,106,4096,4.0
2020-09-03 00:00:00+00:00,Schleswig-Holstein,21,15,109,4117,4.0
2020-09-04 00:00:00+00:00,Schleswig-Holstein,9,14,101,4126,3.0
2020-09-05 00:00:00+00:00,Schleswig-Holstein,8,14,104,4134,4.0
2020-09-06 00:00:00+00:00,Schleswig-Holstein,4,14,99,4138,3.0
2020-09-07 00:00:00+00:00,Schleswig-Holstein,19,14,103,4157,4.0
2020-09-08 00:00:00+00:00,Schleswig-Holstein,21,15,108,4178,4.0
2020-09-09 00:00:00+00:00,Schleswig-Holstein,24,15,106,4202,4.0
2020-09-10 00:00:00+00:00,Schleswig-Holstein,16,14,101,4218,3.0
2020-09-11 00:00:00+00:00,Schleswig-Holstein,11,14,103,4229,4.0
2020-09-12 00:00:00+00:00,Schleswig-Holstein,9,14,104,4238,4.0
2020-09-13 00:00:00+00:00,Schleswig-Holstein,9,15,109,4247,4.0
2020-09-14 00:00:00+00:00,Schleswig-Holstein,24,16,114,4271,4.0
2020-09-15 00:00:00+00:00,Schleswig-Holstein,35,18,128,4306,4.0
2020-09-16 00:00:00+00:00,Schleswig-Holstein,30,19,134,4336,5.0
2020-09-17 00:00:00+00:00,Schleswig-Holstein,36,22,154,4372,5.0
2020-09-18 00:00:00+00:00,Schleswig-Holstein,32,25,175,4404,6.0
2020-09-19 00:00:00+00:00,Schleswig-Holstein,29,27,195,4433,7.0
2020-09-20 00:00:00+00:00,Schleswig-Holstein,17,29,203,4450,7.0
2020-09-21 00:00:00+00:00,Schleswig-Holstein,27,29,206,4477,7.0
2020-09-22 00:00:00+00:00,Schleswig-Holstein,30,28,201,4507,7.0
2020-09-23 00:00:00+00:00,Schleswig-Holstein,48,31,219,4555,8.0
2020-09-24 00:00:00+00:00,Schleswig-Holstein,57,34,240,4612,8.0
2020-09-25 00:00:00+00:00,Schleswig-Holstein,58,38,266,4670,9.0
2020-09-26 00:00:00+00:00,Schleswig-Holstein,23,37,260,4693,9.0
2020-09-27 00:00:00+00:00,Schleswig-Holstein,7,35,250,4700,9.0
2020-09-28 00:00:00+00:00,Schleswig-Holstein,44,38,267,4744,9.0
2020-09-29 00:00:00+00:00,Schleswig-Holstein,46,40,283,4790,10.0
2020-09-30 00:00:00+00:00,Schleswig-Holstein,44,39,279,4834,10.0
2020-10-01 00:00:00+00:00,Schleswig-Holstein,37,37,259,4871,9.0
2020-10-02 00:00:00+00:00,Schleswig-Holstein,39,34,240,4910,8.0
2020-10-03 00:00:00+00:00,Schleswig-Holstein,19,33,236,4929,8.0
2020-10-04 00:00:00+00:00,Schleswig-Holstein,23,36,252,4952,9.0
2020-10-05 00:00:00+00:00,Schleswig-Holstein,35,34,243,4987,8.0
2020-10-06 00:00:00+00:00,Schleswig-Holstein,54,35,251,5041,9.0
2020-10-07 00:00:00+00:00,Schleswig-Holstein,54,37,261,5095,9.0
2020-10-08 00:00:00+00:00,Schleswig-Holstein,63,41,287,5158,10.0
2020-10-09 00:00:00+00:00,Schleswig-Holstein,57,43,305,5215,11.0
2020-10-10 00:00:00+00:00,Schleswig-Holstein,26,44,312,5241,11.0
2020-10-11 00:00:00+00:00,Schleswig-Holstein,22,44,311,5263,11.0
2020-10-12 00:00:00+00:00,Schleswig-Holstein,66,48,342,5329,12.0
2020-10-13 00:00:00+00:00,Schleswig-Holstein,66,50,354,5395,12.0
2020-10-14 00:00:00+00:00,Schleswig-Holstein,71,53,371,5466,13.0
2020-10-15 00:00:00+00:00,Schleswig-Holstein,80,55,388,5546,13.0
2020-10-16 00:00:00+00:00,Schleswig-Holstein,94,60,425,5640,15.0
2020-10-17 00:00:00+00:00,Schleswig-Holstein,51,64,450,5691,15.0
2020-10-18 00:00:00+00:00,Schleswig-Holstein,34,66,462,5725,16.0
2020-10-19 00:00:00+00:00,Schleswig-Holstein,158,79,554,5883,19.0
2020-10-20 00:00:00+00:00,Schleswig-Holstein,125,87,613,6008,21.0
2020-10-21 00:00:00+00:00,Schleswig-Holstein,162,100,704,6170,24.0
2020-10-22 00:00:00+00:00,Schleswig-Holstein,225,121,849,6395,29.0
2020-10-23 00:00:00+00:00,Schleswig-Holstein,192,135,947,6587,33.0
2020-10-24 00:00:00+00:00,Schleswig-Holstein,151,149,1047,6738,36.0
2020-10-25 00:00:00+00:00,Schleswig-Holstein,78,155,1091,6816,38.0
2020-10-26 00:00:00+00:00,Schleswig-Holstein,156,155,1089,6972,38.0
2020-10-27 00:00:00+00:00,Schleswig-Holstein,284,178,1248,7256,43.0
2020-10-28 00:00:00+00:00,Schleswig-Holstein,269,193,1355,7525,47.0
2020-10-29 00:00:00+00:00,Schleswig-Holstein,251,197,1381,7776,48.0
2020-10-30 00:00:00+00:00,Schleswig-Holstein,301,212,1490,8077,51.0
2020-10-31 00:00:00+00:00,Schleswig-Holstein,240,225,1579,8317,54.0
2020-11-01 00:00:00+00:00,Schleswig-Holstein,149,235,1650,8466,57.0
2020-11-02 00:00:00+00:00,Schleswig-Holstein,174,238,1668,8640,57.0
2020-11-03 00:00:00+00:00,Schleswig-Holstein,219,229,1603,8859,55.0
2020-11-04 00:00:00+00:00,Schleswig-Holstein,247,225,1581,9106,54.0
2020-11-05 00:00:00+00:00,Schleswig-Holstein,257,226,1587,9363,55.0
2020-11-06 00:00:00+00:00,Schleswig-Holstein,231,216,1517,9594,52.0
2020-11-07 00:00:00+00:00,Schleswig-Holstein,248,217,1525,9842,53.0
2020-11-08 00:00:00+00:00,Schleswig-Holstein,154,218,1530,9996,53.0
2020-11-09 00:00:00+00:00,Schleswig-Holstein,246,228,1602,10242,55.0
2020-11-10 00:00:00+00:00,Schleswig-Holstein,210,227,1593,10452,55.0
2020-11-11 00:00:00+00:00,Schleswig-Holstein,284,232,1630,10736,56.0
2020-11-12 00:00:00+00:00,Schleswig-Holstein,226,228,1599,10962,55.0
2020-11-13 00:00:00+00:00,Schleswig-Holstein,288,236,1656,11250,57.0
2020-11-14 00:00:00+00:00,Schleswig-Holstein,189,228,1597,11439,55.0
2020-11-15 00:00:00+00:00,Schleswig-Holstein,100,220,1543,11539,53.0
2020-11-16 00:00:00+00:00,Schleswig-Holstein,127,203,1424,11666,49.0
2020-11-17 00:00:00+00:00,Schleswig-Holstein,246,208,1460,11912,50.0
2020-11-18 00:00:00+00:00,Schleswig-Holstein,233,201,1409,12145,49.0
2020-11-19 00:00:00+00:00,Schleswig-Holstein,233,202,1416,12378,49.0
2020-11-20 00:00:00+00:00,Schleswig-Holstein,268,199,1396,12646,48.0
2020-11-21 00:00:00+00:00,Schleswig-Holstein,142,192,1349,12788,46.0
2020-11-22 00:00:00+00:00,Schleswig-Holstein,114,194,1363,12902,47.0
2020-11-23 00:00:00+00:00,Schleswig-Holstein,151,198,1387,13053,48.0
2020-11-24 00:00:00+00:00,Schleswig-Holstein,220,194,1361,13273,47.0
2020-11-25 00:00:00+00:00,Schleswig-Holstein,267,199,1395,13540,48.0
2020-11-26 00:00:00+00:00,Schleswig-Holstein,234,199,1396,13774,48.0
2020-11-27 00:00:00+00:00,Schleswig-Holstein,229,193,1357,14003,47.0
2020-11-28 00:00:00+00:00,Schleswig-Holstein,169,197,1384,14172,48.0
2020-11-29 00:00:00+00:00,Schleswig-Holstein,76,192,1346,14248,46.0
2020-11-30 00:00:00+00:00,Schleswig-Holstein,107,186,1302,14355,45.0
2020-12-01 00:00:00+00:00,Schleswig-Holstein,205,183,1287,14560,44.0
2020-12-02 00:00:00+00:00,Schleswig-Holstein,281,185,1301,14841,45.0
2020-12-03 00:00:00+00:00,Schleswig-Holstein,250,188,1317,15091,45.0
2020-12-04 00:00:00+00:00,Schleswig-Holstein,272,194,1360,15363,47.0
2020-12-05 00:00:00+00:00,Schleswig-Holstein,259,207,1450,15622,50.0
2020-12-06 00:00:00+00:00,Schleswig-Holstein,119,213,1493,15741,51.0
2020-12-07 00:00:00+00:00,Schleswig-Holstein,176,223,1562,15917,54.0
2020-12-08 00:00:00+00:00,Schleswig-Holstein,355,244,1712,16272,59.0
2020-12-09 00:00:00+00:00,Schleswig-Holstein,341,253,1772,16613,61.0
2020-12-10 00:00:00+00:00,Schleswig-Holstein,460,283,1982,17073,68.0
2020-12-11 00:00:00+00:00,Schleswig-Holstein,424,304,2134,17497,73.0
2020-12-12 00:00:00+00:00,Schleswig-Holstein,438,330,2313,17935,80.0
2020-12-13 00:00:00+00:00,Schleswig-Holstein,142,333,2336,18077,80.0
2020-12-14 00:00:00+00:00,Schleswig-Holstein,211,338,2371,18288,82.0
2020-12-15 00:00:00+00:00,Schleswig-Holstein,495,358,2511,18783,86.0
2020-12-16 00:00:00+00:00,Schleswig-Holstein,519,384,2689,19302,93.0
2020-12-17 00:00:00+00:00,Schleswig-Holstein,482,387,2711,19784,93.0
2020-12-18 00:00:00+00:00,Schleswig-Holstein,549,405,2836,20333,98.0
2020-12-19 00:00:00+00:00,Schleswig-Holstein,429,403,2827,20762,97.0
2020-12-20 00:00:00+00:00,Schleswig-Holstein,190,410,2875,20952,99.0
2020-12-21 00:00:00+00:00,Schleswig-Holstein,274,419,2938,21226,101.0
2020-12-22 00:00:00+00:00,Schleswig-Holstein,582,432,3025,21808,104.0
2020-12-23 00:00:00+00:00,Schleswig-Holstein,664,452,3170,22472,109.0
2020-12-24 00:00:00+00:00,Schleswig-Holstein,362,435,3050,22834,105.0
2020-12-25 00:00:00+00:00,Schleswig-Holstein,174,382,2675,23008,92.0
2020-12-26 00:00:00+00:00,Schleswig-Holstein,196,348,2442,23204,84.0
2020-12-27 00:00:00+00:00,Schleswig-Holstein,187,348,2439,23391,84.0
2020-12-28 00:00:00+00:00,Schleswig-Holstein,266,347,2431,23657,84.0
2020-12-29 00:00:00+00:00,Schleswig-Holstein,573,346,2422,24230,83.0
2020-12-30 00:00:00+00:00,Schleswig-Holstein,459,316,2217,24689,76.0
2020-12-31 00:00:00+00:00,Schleswig-Holstein,353,315,2208,25042,76.0
2021-01-01 00:00:00+00:00,Schleswig-Holstein,137,310,2171,25179,75.0
2021-01-02 00:00:00+00:00,Schleswig-Holstein,264,319,2239,25443,77.0
2021-01-03 00:00:00+00:00,Schleswig-Holstein,201,321,2253,25644,78.0
2021-01-04 00:00:00+00:00,Schleswig-Holstein,262,321,2249,25906,77.0
2021-01-05 00:00:00+00:00,Schleswig-Holstein,538,316,2214,26444,76.0
2021-01-06 00:00:00+00:00,Schleswig-Holstein,531,326,2286,26975,79.0
2021-01-07 00:00:00+00:00,Schleswig-Holstein,476,344,2409,27451,83.0
2021-01-08 00:00:00+00:00,Schleswig-Holstein,522,399,2794,27973,96.0
2021-01-09 00:00:00+00:00,Schleswig-Holstein,406,419,2936,28379,101.0
2021-01-10 00:00:00+00:00,Schleswig-Holstein,140,410,2875,28519,99.0
2021-01-11 00:00:00+00:00,Schleswig-Holstein,258,410,2871,28777,99.0
2021-01-12 00:00:00+00:00,Schleswig-Holstein,405,391,2738,29182,94.0
2021-01-13 00:00:00+00:00,Schleswig-Holstein,485,384,2692,29667,93.0
2021-01-14 00:00:00+00:00,Schleswig-Holstein,419,376,2635,30086,91.0
2021-01-15 00:00:00+00:00,Schleswig-Holstein,409,360,2522,30495,87.0
2021-01-16 00:00:00+00:00,Schleswig-Holstein,351,352,2467,30846,85.0
2021-01-17 00:00:00+00:00,Schleswig-Holstein,200,361,2527,31046,87.0
2021-01-18 00:00:00+00:00,Schleswig-Holstein,236,357,2505,31282,86.0
2021-01-19 00:00:00+00:00,Schleswig-Holstein,462,366,2562,31744,88.0
2021-01-20 00:00:00+00:00,Schleswig-Holstein,481,365,2558,32225,88.0
2021-01-21 00:00:00+00:00,Schleswig-Holstein,498,376,2637,32723,91.0
2021-01-22 00:00:00+00:00,Schleswig-Holstein,461,384,2689,33184,93.0
2021-01-23 00:00:00+00:00,Schleswig-Holstein,439,396,2777,33623,96.0
2021-01-24 00:00:00+00:00,Schleswig-Holstein,156,390,2733,33779,94.0
2021-01-25 00:00:00+00:00,Schleswig-Holstein,161,379,2658,33940,92.0
2021-01-26 00:00:00+00:00,Schleswig-Holstein,541,391,2737,34481,94.0
2021-01-27 00:00:00+00:00,Schleswig-Holstein,462,388,2718,34943,94.0
2021-01-28 00:00:00+00:00,Schleswig-Holstein,381,371,2601,35324,90.0
2021-01-29 00:00:00+00:00,Schleswig-Holstein,346,355,2486,35670,86.0
2021-01-30 00:00:00+00:00,Schleswig-Holstein,261,329,2308,35931,79.0
2021-01-31 00:00:00+00:00,Schleswig-Holstein,178,332,2330,36109,80.0
2021-02-01 00:00:00+00:00,Schleswig-Holstein,130,328,2299,36239,79.0
2021-02-02 00:00:00+00:00,Schleswig-Holstein,357,302,2115,36596,73.0
2021-02-03 00:00:00+00:00,Schleswig-Holstein,338,284,1991,36934,69.0
2021-02-04 00:00:00+00:00,Schleswig-Holstein,323,276,1933,37257,67.0
2021-02-05 00:00:00+00:00,Schleswig-Holstein,259,263,1846,37516,64.0
2021-02-06 00:00:00+00:00,Schleswig-Holstein,267,264,1852,37783,64.0
2021-02-07 00:00:00+00:00,Schleswig-Holstein,106,254,1780,37889,61.0
2021-02-08 00:00:00+00:00,Schleswig-Holstein,136,255,1786,38025,62.0
2021-02-09 00:00:00+00:00,Schleswig-Holstein,312,248,1741,38337,60.0
2021-02-10 00:00:00+00:00,Schleswig-Holstein,333,248,1736,38670,60.0
2021-02-11 00:00:00+00:00,Schleswig-Holstein,355,252,1768,39025,61.0
2021-02-12 00:00:00+00:00,Schleswig-Holstein,224,247,1733,39249,60.0
2021-02-13 00:00:00+00:00,Schleswig-Holstein,190,236,1656,39439,57.0
2021-02-14 00:00:00+00:00,Schleswig-Holstein,116,238,1666,39555,57.0
2021-02-15 00:00:00+00:00,Schleswig-Holstein,140,238,1670,39695,58.0
2021-02-16 00:00:00+00:00,Schleswig-Holstein,251,229,1609,39946,55.0
2021-02-17 00:00:00+00:00,Schleswig-Holstein,245,217,1521,40191,52.0
2021-02-18 00:00:00+00:00,Schleswig-Holstein,254,202,1420,40445,49.0
2021-02-19 00:00:00+00:00,Schleswig-Holstein,266,208,1462,40711,50.0
2021-02-20 00:00:00+00:00,Schleswig-Holstein,200,210,1472,40911,51.0
2021-02-21 00:00:00+00:00,Schleswig-Holstein,113,209,1469,41024,51.0
2021-02-22 00:00:00+00:00,Schleswig-Holstein,103,204,1432,41127,49.0
2021-02-23 00:00:00+00:00,Schleswig-Holstein,282,209,1463,41409,50.0
2021-02-24 00:00:00+00:00,Schleswig-Holstein,252,210,1470,41661,51.0
2021-02-25 00:00:00+00:00,Schleswig-Holstein,249,209,1465,41910,50.0
2021-02-26 00:00:00+00:00,Schleswig-Holstein,265,209,1464,42175,50.0
2021-02-27 00:00:00+00:00,Schleswig-Holstein,198,208,1462,42373,50.0
2021-02-28 00:00:00+00:00,Schleswig-Holstein,90,205,1439,42463,50.0
2021-03-01 00:00:00+00:00,Schleswig-Holstein,103,205,1439,42566,50.0
2021-03-02 00:00:00+00:00,Schleswig-Holstein,222,197,1379,42788,47.0
2021-03-03 00:00:00+00:00,Schleswig-Holstein,255,197,1382,43043,48.0
2021-03-04 00:00:00+00:00,Schleswig-Holstein,229,194,1362,43272,47.0
2021-03-05 00:00:00+00:00,Schleswig-Holstein,217,187,1314,43489,45.0
2021-03-06 00:00:00+00:00,Schleswig-Holstein,213,189,1329,43702,46.0
2021-03-07 00:00:00+00:00,Schleswig-Holstein,71,187,1310,43773,45.0
2021-03-08 00:00:00+00:00,Schleswig-Holstein,114,188,1321,43887,45.0
2021-03-09 00:00:00+00:00,Schleswig-Holstein,254,193,1353,44141,47.0
2021-03-10 00:00:00+00:00,Schleswig-Holstein,271,195,1369,44412,47.0
2021-03-11 00:00:00+00:00,Schleswig-Holstein,267,201,1407,44679,48.0
2021-03-12 00:00:00+00:00,Schleswig-Holstein,236,203,1426,44915,49.0
2021-03-13 00:00:00+00:00,Schleswig-Holstein,272,212,1485,45187,51.0
2021-03-14 00:00:00+00:00,Schleswig-Holstein,77,213,1491,45264,51.0
2021-03-15 00:00:00+00:00,Schleswig-Holstein,128,215,1505,45392,52.0
2021-03-16 00:00:00+00:00,Schleswig-Holstein,313,223,1564,45705,54.0
2021-03-17 00:00:00+00:00,Schleswig-Holstein,327,231,1620,46032,56.0
2021-03-18 00:00:00+00:00,Schleswig-Holstein,290,234,1643,46322,57.0
2021-03-19 00:00:00+00:00,Schleswig-Holstein,281,241,1688,46603,58.0
2021-03-20 00:00:00+00:00,Schleswig-Holstein,298,244,1714,46901,59.0
2021-03-21 00:00:00+00:00,Schleswig-Holstein,95,247,1732,46996,60.0
2021-03-22 00:00:00+00:00,Schleswig-Holstein,157,251,1761,47153,61.0
2021-03-23 00:00:00+00:00,Schleswig-Holstein,295,249,1743,47448,60.0
2021-03-24 00:00:00+00:00,Schleswig-Holstein,328,249,1744,47776,60.0
2021-03-25 00:00:00+00:00,Schleswig-Holstein,370,260,1824,48146,63.0
2021-03-26 00:00:00+00:00,Schleswig-Holstein,379,274,1922,48525,66.0
2021-03-27 00:00:00+00:00,Schleswig-Holstein,309,276,1933,48834,67.0
2021-03-28 00:00:00+00:00,Schleswig-Holstein,158,285,1996,48992,69.0
2021-03-29 00:00:00+00:00,Schleswig-Holstein,200,291,2039,49192,70.0
2021-03-30 00:00:00+00:00,Schleswig-Holstein,357,300,2101,49549,72.0
2021-03-31 00:00:00+00:00,Schleswig-Holstein,394,309,2167,49943,75.0
2021-04-01 00:00:00+00:00,Schleswig-Holstein,358,307,2155,50301,74.0
2021-04-02 00:00:00+00:00,Schleswig-Holstein,322,299,2098,50623,72.0
2021-04-03 00:00:00+00:00,Schleswig-Holstein,202,284,1991,50825,69.0
2021-04-04 00:00:00+00:00,Schleswig-Holstein,170,286,2003,50995,69.0
2021-04-05 00:00:00+00:00,Schleswig-Holstein,205,286,2008,51200,69.0
2021-04-06 00:00:00+00:00,Schleswig-Holstein,202,264,1853,51402,64.0
2021-04-07 00:00:00+00:00,Schleswig-Holstein,412,267,1871,51814,64.0
2021-04-08 00:00:00+00:00,Schleswig-Holstein,398,273,1911,52212,66.0
2021-04-09 00:00:00+00:00,Schleswig-Holstein,356,277,1945,52568,67.0
2021-04-10 00:00:00+00:00,Schleswig-Holstein,362,300,2105,52930,72.0
2021-04-11 00:00:00+00:00,Schleswig-Holstein,170,300,2105,53100,72.0
2021-04-12 00:00:00+00:00,Schleswig-Holstein,203,300,2103,53303,72.0
2021-04-13 00:00:00+00:00,Schleswig-Holstein,422,331,2323,53725,80.0
2021-04-14 00:00:00+00:00,Schleswig-Holstein,375,326,2286,54100,79.0
2021-04-15 00:00:00+00:00,Schleswig-Holstein,344,318,2232,54444,77.0
2021-04-16 00:00:00+00:00,Schleswig-Holstein,288,309,2164,54732,75.0
2021-04-17 00:00:00+00:00,Schleswig-Holstein,325,303,2127,55057,73.0
2021-04-18 00:00:00+00:00,Schleswig-Holstein,173,304,2130,55230,73.0
2021-04-19 00:00:00+00:00,Schleswig-Holstein,205,304,2132,55435,73.0
2021-04-20 00:00:00+00:00,Schleswig-Holstein,412,303,2122,55847,73.0
2021-04-21 00:00:00+00:00,Schleswig-Holstein,379,303,2126,56226,73.0
2021-04-22 00:00:00+00:00,Schleswig-Holstein,365,306,2147,56591,74.0
2021-04-23 00:00:00+00:00,Schleswig-Holstein,336,313,2195,56927,76.0
2021-04-24 00:00:00+00:00,Schleswig-Holstein,332,314,2202,57259,76.0
2021-04-25 00:00:00+00:00,Schleswig-Holstein,115,306,2144,57374,74.0
2021-04-26 00:00:00+00:00,Schleswig-Holstein,169,301,2108,57543,73.0
2021-04-27 00:00:00+00:00,Schleswig-Holstein,366,294,2062,57909,71.0
2021-04-28 00:00:00+00:00,Schleswig-Holstein,284,281,1967,58193,68.0
2021-04-29 00:00:00+00:00,Schleswig-Holstein,266,266,1868,58459,64.0
2021-04-30 00:00:00+00:00,Schleswig-Holstein,267,257,1799,58726,62.0
2021-05-01 00:00:00+00:00,Schleswig-Holstein,241,244,1708,58967,59.0
2021-05-02 00:00:00+00:00,Schleswig-Holstein,91,240,1684,59058,58.0
2021-05-03 00:00:00+00:00,Schleswig-Holstein,159,239,1674,59217,58.0
2021-05-04 00:00:00+00:00,Schleswig-Holstein,288,228,1596,59505,55.0
2021-05-05 00:00:00+00:00,Schleswig-Holstein,293,229,1605,59798,55.0
2021-05-06 00:00:00+00:00,Schleswig-Holstein,224,223,1563,60022,54.0
2021-05-07 00:00:00+00:00,Schleswig-Holstein,227,217,1523,60249,52.0
2021-05-08 00:00:00+00:00,Schleswig-Holstein,212,213,1494,60461,51.0
2021-05-09 00:00:00+00:00,Schleswig-Holstein,108,215,1511,60569,52.0
2021-05-10 00:00:00+00:00,Schleswig-Holstein,128,211,1480,60697,51.0
2021-05-11 00:00:00+00:00,Schleswig-Holstein,236,204,1428,60933,49.0
2021-05-12 00:00:00+00:00,Schleswig-Holstein,211,192,1346,61144,46.0
2021-05-13 00:00:00+00:00,Schleswig-Holstein,148,181,1270,61292,44.0
2021-05-14 00:00:00+00:00,Schleswig-Holstein,98,163,1141,61390,39.0
2021-05-15 00:00:00+00:00,Schleswig-Holstein,151,154,1080,61541,37.0
2021-05-16 00:00:00+00:00,Schleswig-Holstein,59,147,1031,61600,36.0
2021-05-17 00:00:00+00:00,Schleswig-Holstein,94,142,997,61694,34.0
2021-05-18 00:00:00+00:00,Schleswig-Holstein,203,137,964,61897,33.0
2021-05-19 00:00:00+00:00,Schleswig-Holstein,177,132,930,62074,32.0
2021-05-20 00:00:00+00:00,Schleswig-Holstein,114,128,896,62188,31.0
2021-05-21 00:00:00+00:00,Schleswig-Holstein,159,136,957,62347,33.0
2021-05-22 00:00:00+00:00,Schleswig-Holstein,102,129,908,62449,31.0
2021-05-23 00:00:00+00:00,Schleswig-Holstein,34,126,883,62483,30.0
2021-05-24 00:00:00+00:00,Schleswig-Holstein,74,123,863,62557,30.0
2021-05-25 00:00:00+00:00,Schleswig-Holstein,53,101,713,62610,25.0
2021-05-26 00:00:00+00:00,Schleswig-Holstein,110,92,646,62720,22.0
2021-05-27 00:00:00+00:00,Schleswig-Holstein,81,87,613,62801,21.0
2021-05-28 00:00:00+00:00,Schleswig-Holstein,100,79,554,62901,19.0
2021-05-29 00:00:00+00:00,Schleswig-Holstein,72,74,524,62973,18.0
2021-05-30 00:00:00+00:00,Schleswig-Holstein,41,75,531,63014,18.0
2021-05-31 00:00:00+00:00,Schleswig-Holstein,51,72,508,63065,17.0
2021-06-01 00:00:00+00:00,Schleswig-Holstein,65,74,520,63130,18.0
2021-06-02 00:00:00+00:00,Schleswig-Holstein,87,71,497,63217,17.0
2021-06-03 00:00:00+00:00,Schleswig-Holstein,49,66,465,63266,16.0
2021-06-04 00:00:00+00:00,Schleswig-Holstein,50,59,415,63316,14.0
2021-06-05 00:00:00+00:00,Schleswig-Holstein,41,54,384,63357,13.0
2021-06-06 00:00:00+00:00,Schleswig-Holstein,13,50,356,63370,12.0
2021-06-07 00:00:00+00:00,Schleswig-Holstein,28,47,333,63398,11.0
2021-06-08 00:00:00+00:00,Schleswig-Holstein,56,46,324,63454,11.0
2021-06-09 00:00:00+00:00,Schleswig-Holstein,58,42,295,63512,10.0
2021-06-10 00:00:00+00:00,Schleswig-Holstein,37,40,283,63549,10.0
2021-06-11 00:00:00+00:00,Schleswig-Holstein,37,38,270,63586,9.0
2021-06-12 00:00:00+00:00,Schleswig-Holstein,34,37,263,63620,9.0
2021-06-13 00:00:00+00:00,Schleswig-Holstein,4,36,254,63624,9.0
2021-06-14 00:00:00+00:00,Schleswig-Holstein,11,33,237,63635,8.0
2021-06-15 00:00:00+00:00,Schleswig-Holstein,22,29,203,63657,7.0
2021-06-16 00:00:00+00:00,Schleswig-Holstein,30,25,175,63687,6.0
2021-06-17 00:00:00+00:00,Schleswig-Holstein,23,23,161,63710,6.0
2021-06-18 00:00:00+00:00,Schleswig-Holstein,24,21,148,63734,5.0
2021-06-19 00:00:00+00:00,Schleswig-Holstein,16,18,130,63750,4.0
2021-06-20 00:00:00+00:00,Schleswig-Holstein,5,18,131,63755,5.0
2021-06-21 00:00:00+00:00,Schleswig-Holstein,16,19,136,63771,5.0
2021-06-22 00:00:00+00:00,Schleswig-Holstein,18,18,132,63789,5.0
2021-06-23 00:00:00+00:00,Schleswig-Holstein,14,16,116,63803,4.0
2021-06-24 00:00:00+00:00,Schleswig-Holstein,11,14,104,63814,4.0
2021-06-25 00:00:00+00:00,Schleswig-Holstein,16,13,96,63830,3.0
2021-06-26 00:00:00+00:00,Schleswig-Holstein,17,13,97,63847,3.0
2021-06-27 00:00:00+00:00,Schleswig-Holstein,3,13,95,63850,3.0
2021-06-28 00:00:00+00:00,Schleswig-Holstein,18,13,97,63868,3.0
2021-06-29 00:00:00+00:00,Schleswig-Holstein,17,13,96,63885,3.0
2021-06-30 00:00:00+00:00,Schleswig-Holstein,12,13,94,63897,3.0
2021-07-01 00:00:00+00:00,Schleswig-Holstein,13,13,96,63910,3.0
2021-07-02 00:00:00+00:00,Schleswig-Holstein,19,14,99,63929,3.0
2021-07-03 00:00:00+00:00,Schleswig-Holstein,23,15,105,63952,4.0
2021-07-04 00:00:00+00:00,Schleswig-Holstein,4,15,106,63956,4.0
2021-07-05 00:00:00+00:00,Schleswig-Holstein,11,14,99,63967,3.0
2021-07-06 00:00:00+00:00,Schleswig-Holstein,11,13,93,63978,3.0
2020-02-29 00:00:00+00:00,Berlin,1,0,0,1,0.0
2020-03-03 00:00:00+00:00,Berlin,6,0,0,7,0.0
2020-03-04 00:00:00+00:00,Berlin,3,0,0,10,0.0
2020-03-05 00:00:00+00:00,Berlin,10,0,0,20,0.0
2020-03-06 00:00:00+00:00,Berlin,5,0,0,25,0.0
2020-03-07 00:00:00+00:00,Berlin,1,0,0,26,0.0
2020-03-08 00:00:00+00:00,Berlin,11,5,37,37,1.0
2020-03-09 00:00:00+00:00,Berlin,21,8,57,58,2.0
2020-03-10 00:00:00+00:00,Berlin,33,12,84,91,2.0
2020-03-11 00:00:00+00:00,Berlin,41,17,122,132,3.0
2020-03-12 00:00:00+00:00,Berlin,47,22,159,179,4.0
2020-03-13 00:00:00+00:00,Berlin,59,30,213,238,6.0
2020-03-14 00:00:00+00:00,Berlin,29,34,241,267,7.0
2020-03-15 00:00:00+00:00,Berlin,26,36,256,293,7.0
2020-03-16 00:00:00+00:00,Berlin,63,42,298,356,8.0
2020-03-17 00:00:00+00:00,Berlin,93,51,358,449,10.0
2020-03-18 00:00:00+00:00,Berlin,145,66,462,594,13.0
2020-03-19 00:00:00+00:00,Berlin,180,85,595,774,16.0
2020-03-20 00:00:00+00:00,Berlin,170,100,706,944,19.0
2020-03-21 00:00:00+00:00,Berlin,127,114,804,1071,22.0
2020-03-22 00:00:00+00:00,Berlin,68,120,846,1139,23.0
2020-03-23 00:00:00+00:00,Berlin,160,134,943,1299,26.0
2020-03-24 00:00:00+00:00,Berlin,199,149,1049,1498,29.0
2020-03-25 00:00:00+00:00,Berlin,244,164,1148,1742,31.0
2020-03-26 00:00:00+00:00,Berlin,286,179,1254,2028,34.0
2020-03-27 00:00:00+00:00,Berlin,205,184,1289,2233,35.0
2020-03-28 00:00:00+00:00,Berlin,200,194,1362,2433,37.0
2020-03-29 00:00:00+00:00,Berlin,86,197,1380,2519,38.0
2020-03-30 00:00:00+00:00,Berlin,168,198,1388,2687,38.0
2020-03-31 00:00:00+00:00,Berlin,213,200,1402,2900,38.0
2020-04-01 00:00:00+00:00,Berlin,187,192,1345,3087,37.0
2020-04-02 00:00:00+00:00,Berlin,238,185,1297,3325,35.0
2020-04-03 00:00:00+00:00,Berlin,238,190,1330,3563,36.0
2020-04-04 00:00:00+00:00,Berlin,108,176,1238,3671,34.0
2020-04-05 00:00:00+00:00,Berlin,78,175,1230,3749,34.0
2020-04-06 00:00:00+00:00,Berlin,143,172,1205,3892,33.0
2020-04-07 00:00:00+00:00,Berlin,202,170,1194,4094,33.0
2020-04-08 00:00:00+00:00,Berlin,177,169,1184,4271,32.0
2020-04-09 00:00:00+00:00,Berlin,177,160,1123,4448,31.0
2020-04-10 00:00:00+00:00,Berlin,83,138,968,4531,26.0
2020-04-11 00:00:00+00:00,Berlin,87,135,947,4618,26.0
2020-04-12 00:00:00+00:00,Berlin,55,132,924,4673,25.0
2020-04-13 00:00:00+00:00,Berlin,58,119,839,4731,23.0
2020-04-14 00:00:00+00:00,Berlin,74,101,711,4805,19.0
2020-04-15 00:00:00+00:00,Berlin,113,92,647,4918,18.0
2020-04-16 00:00:00+00:00,Berlin,94,80,564,5012,15.0
2020-04-17 00:00:00+00:00,Berlin,120,85,601,5132,16.0
2020-04-18 00:00:00+00:00,Berlin,81,85,595,5213,16.0
2020-04-19 00:00:00+00:00,Berlin,32,81,572,5245,16.0
2020-04-20 00:00:00+00:00,Berlin,45,79,559,5290,15.0
2020-04-21 00:00:00+00:00,Berlin,76,80,561,5366,15.0
2020-04-22 00:00:00+00:00,Berlin,81,75,529,5447,14.0
2020-04-23 00:00:00+00:00,Berlin,87,74,522,5534,14.0
2020-04-24 00:00:00+00:00,Berlin,73,67,475,5607,13.0
2020-04-25 00:00:00+00:00,Berlin,54,64,448,5661,12.0
2020-04-26 00:00:00+00:00,Berlin,21,62,437,5682,12.0
2020-04-27 00:00:00+00:00,Berlin,55,63,447,5737,12.0
2020-04-28 00:00:00+00:00,Berlin,80,64,451,5817,12.0
2020-04-29 00:00:00+00:00,Berlin,68,62,438,5885,12.0
2020-04-30 00:00:00+00:00,Berlin,57,58,408,5942,11.0
2020-05-01 00:00:00+00:00,Berlin,25,51,360,5967,10.0
2020-05-02 00:00:00+00:00,Berlin,31,48,337,5998,9.0
2020-05-03 00:00:00+00:00,Berlin,32,49,348,6030,9.0
2020-05-04 00:00:00+00:00,Berlin,51,49,344,6081,9.0
2020-05-05 00:00:00+00:00,Berlin,53,45,317,6134,9.0
2020-05-06 00:00:00+00:00,Berlin,58,43,307,6192,8.0
2020-05-07 00:00:00+00:00,Berlin,58,44,308,6250,8.0
2020-05-08 00:00:00+00:00,Berlin,4,41,287,6254,8.0
2020-05-09 00:00:00+00:00,Berlin,17,39,273,6271,7.0
2020-05-10 00:00:00+00:00,Berlin,8,35,249,6279,7.0
2020-05-11 00:00:00+00:00,Berlin,17,30,215,6296,6.0
2020-05-12 00:00:00+00:00,Berlin,37,28,199,6333,5.0
2020-05-13 00:00:00+00:00,Berlin,58,28,199,6391,5.0
2020-05-14 00:00:00+00:00,Berlin,45,26,186,6436,5.0
2020-05-15 00:00:00+00:00,Berlin,16,28,198,6452,5.0
2020-05-16 00:00:00+00:00,Berlin,16,28,197,6468,5.0
2020-05-17 00:00:00+00:00,Berlin,8,28,197,6476,5.0
2020-05-18 00:00:00+00:00,Berlin,33,30,213,6509,6.0
2020-05-19 00:00:00+00:00,Berlin,46,31,222,6555,6.0
2020-05-20 00:00:00+00:00,Berlin,46,30,210,6601,6.0
2020-05-21 00:00:00+00:00,Berlin,10,25,175,6611,5.0
2020-05-22 00:00:00+00:00,Berlin,35,27,194,6646,5.0
2020-05-23 00:00:00+00:00,Berlin,8,26,186,6654,5.0
2020-05-24 00:00:00+00:00,Berlin,3,25,181,6657,5.0
2020-05-25 00:00:00+00:00,Berlin,22,24,170,6679,5.0
2020-05-26 00:00:00+00:00,Berlin,22,20,146,6701,4.0
2020-05-27 00:00:00+00:00,Berlin,42,20,142,6743,4.0
2020-05-28 00:00:00+00:00,Berlin,24,22,156,6767,4.0
2020-05-29 00:00:00+00:00,Berlin,29,21,150,6796,4.0
2020-05-30 00:00:00+00:00,Berlin,23,23,165,6819,4.0
2020-05-31 00:00:00+00:00,Berlin,27,27,189,6846,5.0
2020-06-01 00:00:00+00:00,Berlin,2,24,169,6848,5.0
2020-06-02 00:00:00+00:00,Berlin,41,26,188,6889,5.0
2020-06-03 00:00:00+00:00,Berlin,55,28,201,6944,5.0
2020-06-04 00:00:00+00:00,Berlin,32,29,209,6976,6.0
2020-06-05 00:00:00+00:00,Berlin,35,30,215,7011,6.0
2020-06-06 00:00:00+00:00,Berlin,16,29,208,7027,6.0
2020-06-07 00:00:00+00:00,Berlin,8,27,189,7035,5.0
2020-06-08 00:00:00+00:00,Berlin,29,30,216,7064,6.0
2020-06-09 00:00:00+00:00,Berlin,57,33,232,7121,6.0
2020-06-10 00:00:00+00:00,Berlin,77,36,254,7198,7.0
2020-06-11 00:00:00+00:00,Berlin,52,39,274,7250,7.0
2020-06-12 00:00:00+00:00,Berlin,42,40,281,7292,8.0
2020-06-13 00:00:00+00:00,Berlin,68,47,333,7360,9.0
2020-06-14 00:00:00+00:00,Berlin,12,48,337,7372,9.0
2020-06-15 00:00:00+00:00,Berlin,31,48,339,7403,9.0
2020-06-16 00:00:00+00:00,Berlin,75,51,357,7478,10.0
2020-06-17 00:00:00+00:00,Berlin,85,52,365,7563,10.0
2020-06-18 00:00:00+00:00,Berlin,128,63,441,7691,12.0
2020-06-19 00:00:00+00:00,Berlin,136,76,535,7827,15.0
2020-06-20 00:00:00+00:00,Berlin,35,71,502,7862,14.0
2020-06-21 00:00:00+00:00,Berlin,20,72,510,7882,14.0
2020-06-22 00:00:00+00:00,Berlin,63,77,542,7945,15.0
2020-06-23 00:00:00+00:00,Berlin,72,77,539,8017,15.0
2020-06-24 00:00:00+00:00,Berlin,58,73,512,8075,14.0
2020-06-25 00:00:00+00:00,Berlin,62,63,446,8137,12.0
2020-06-26 00:00:00+00:00,Berlin,43,50,353,8180,10.0
2020-06-27 00:00:00+00:00,Berlin,17,47,335,8197,9.0
2020-06-28 00:00:00+00:00,Berlin,2,45,317,8199,9.0
2020-06-29 00:00:00+00:00,Berlin,53,43,307,8252,8.0
2020-06-30 00:00:00+00:00,Berlin,35,38,270,8287,7.0
2020-07-01 00:00:00+00:00,Berlin,46,36,258,8333,7.0
2020-07-02 00:00:00+00:00,Berlin,57,36,253,8390,7.0
2020-07-03 00:00:00+00:00,Berlin,41,35,251,8431,7.0
2020-07-04 00:00:00+00:00,Berlin,31,37,265,8462,7.0
2020-07-05 00:00:00+00:00,Berlin,2,37,265,8464,7.0
2020-07-06 00:00:00+00:00,Berlin,33,35,245,8497,7.0
2020-07-07 00:00:00+00:00,Berlin,37,35,247,8534,7.0
2020-07-08 00:00:00+00:00,Berlin,47,35,248,8581,7.0
2020-07-09 00:00:00+00:00,Berlin,34,32,225,8615,6.0
2020-07-10 00:00:00+00:00,Berlin,34,31,218,8649,6.0
2020-07-11 00:00:00+00:00,Berlin,4,27,191,8653,5.0
2020-07-12 00:00:00+00:00,Berlin,1,27,190,8654,5.0
2020-07-13 00:00:00+00:00,Berlin,27,26,184,8681,5.0
2020-07-14 00:00:00+00:00,Berlin,25,24,172,8706,5.0
2020-07-15 00:00:00+00:00,Berlin,24,21,149,8730,4.0
2020-07-16 00:00:00+00:00,Berlin,16,18,131,8746,4.0
2020-07-17 00:00:00+00:00,Berlin,20,16,117,8766,3.0
2020-07-18 00:00:00+00:00,Berlin,19,18,132,8785,4.0
2020-07-20 00:00:00+00:00,Berlin,31,23,162,8816,4.0
2020-07-21 00:00:00+00:00,Berlin,33,24,168,8849,5.0
2020-07-22 00:00:00+00:00,Berlin,27,24,170,8876,5.0
2020-07-23 00:00:00+00:00,Berlin,47,27,193,8923,5.0
2020-07-24 00:00:00+00:00,Berlin,61,34,238,8984,6.0
2020-07-25 00:00:00+00:00,Berlin,18,33,236,9002,6.0
2020-07-26 00:00:00+00:00,Berlin,3,31,220,9005,6.0
2020-07-27 00:00:00+00:00,Berlin,41,32,230,9046,6.0
2020-07-28 00:00:00+00:00,Berlin,64,37,261,9110,7.0
2020-07-29 00:00:00+00:00,Berlin,67,43,301,9177,8.0
2020-07-30 00:00:00+00:00,Berlin,49,43,303,9226,8.0
2020-07-31 00:00:00+00:00,Berlin,76,45,318,9302,9.0
2020-08-01 00:00:00+00:00,Berlin,34,47,334,9336,9.0
2020-08-03 00:00:00+00:00,Berlin,47,54,378,9383,10.0
2020-08-04 00:00:00+00:00,Berlin,57,56,394,9440,11.0
2020-08-05 00:00:00+00:00,Berlin,67,56,397,9507,11.0
2020-08-06 00:00:00+00:00,Berlin,83,59,413,9590,11.0
2020-08-07 00:00:00+00:00,Berlin,103,66,467,9693,13.0
2020-08-08 00:00:00+00:00,Berlin,19,58,410,9712,11.0
2020-08-09 00:00:00+00:00,Berlin,6,54,382,9718,10.0
2020-08-10 00:00:00+00:00,Berlin,94,61,429,9812,12.0
2020-08-11 00:00:00+00:00,Berlin,104,68,476,9916,13.0
2020-08-12 00:00:00+00:00,Berlin,144,79,553,10060,15.0
2020-08-13 00:00:00+00:00,Berlin,89,79,559,10149,15.0
2020-08-14 00:00:00+00:00,Berlin,75,75,531,10224,14.0
2020-08-15 00:00:00+00:00,Berlin,33,77,545,10257,15.0
2020-08-16 00:00:00+00:00,Berlin,3,77,542,10260,15.0
2020-08-17 00:00:00+00:00,Berlin,99,78,547,10359,15.0
2020-08-18 00:00:00+00:00,Berlin,75,74,518,10434,14.0
2020-08-19 00:00:00+00:00,Berlin,74,64,448,10508,12.0
2020-08-20 00:00:00+00:00,Berlin,110,67,469,10618,13.0
2020-08-21 00:00:00+00:00,Berlin,78,67,472,10696,13.0
2020-08-22 00:00:00+00:00,Berlin,32,67,471,10728,13.0
2020-08-23 00:00:00+00:00,Berlin,1,67,469,10729,13.0
2020-08-24 00:00:00+00:00,Berlin,95,66,465,10824,13.0
2020-08-25 00:00:00+00:00,Berlin,69,65,459,10893,13.0
2020-08-26 00:00:00+00:00,Berlin,99,69,484,10992,13.0
2020-08-27 00:00:00+00:00,Berlin,75,64,449,11067,12.0
2020-08-28 00:00:00+00:00,Berlin,104,67,475,11171,13.0
2020-08-29 00:00:00+00:00,Berlin,35,68,478,11206,13.0
2020-08-30 00:00:00+00:00,Berlin,5,68,482,11211,13.0
2020-08-31 00:00:00+00:00,Berlin,126,73,513,11337,14.0
2020-09-01 00:00:00+00:00,Berlin,68,73,512,11405,14.0
2020-09-02 00:00:00+00:00,Berlin,88,71,501,11493,14.0
2020-09-03 00:00:00+00:00,Berlin,77,71,503,11570,14.0
2020-09-04 00:00:00+00:00,Berlin,121,74,520,11691,14.0
2020-09-05 00:00:00+00:00,Berlin,47,76,532,11738,14.0
2020-09-06 00:00:00+00:00,Berlin,3,75,530,11741,14.0
2020-09-07 00:00:00+00:00,Berlin,131,76,535,11872,15.0
2020-09-08 00:00:00+00:00,Berlin,59,75,526,11931,14.0
2020-09-09 00:00:00+00:00,Berlin,114,78,552,12045,15.0
2020-09-10 00:00:00+00:00,Berlin,141,88,616,12186,17.0
2020-09-11 00:00:00+00:00,Berlin,88,83,583,12274,16.0
2020-09-12 00:00:00+00:00,Berlin,43,82,579,12317,16.0
2020-09-13 00:00:00+00:00,Berlin,6,83,582,12323,16.0
2020-09-14 00:00:00+00:00,Berlin,97,78,548,12420,15.0
2020-09-15 00:00:00+00:00,Berlin,117,86,606,12537,17.0
2020-09-16 00:00:00+00:00,Berlin,175,95,667,12712,18.0
2020-09-17 00:00:00+00:00,Berlin,175,100,701,12887,19.0
2020-09-18 00:00:00+00:00,Berlin,192,115,805,13079,22.0
2020-09-19 00:00:00+00:00,Berlin,57,117,819,13136,22.0
2020-09-20 00:00:00+00:00,Berlin,28,120,841,13164,23.0
2020-09-21 00:00:00+00:00,Berlin,193,133,937,13357,26.0
2020-09-22 00:00:00+00:00,Berlin,169,141,989,13526,27.0
2020-09-23 00:00:00+00:00,Berlin,185,142,999,13711,27.0
2020-09-24 00:00:00+00:00,Berlin,228,150,1052,13939,29.0
2020-09-25 00:00:00+00:00,Berlin,206,152,1066,14145,29.0
2020-09-26 00:00:00+00:00,Berlin,83,156,1092,14228,30.0
2020-09-27 00:00:00+00:00,Berlin,27,155,1091,14255,30.0
2020-09-28 00:00:00+00:00,Berlin,201,157,1099,14456,30.0
2020-09-29 00:00:00+00:00,Berlin,216,163,1146,14672,31.0
2020-09-30 00:00:00+00:00,Berlin,274,176,1235,14946,34.0
2020-10-01 00:00:00+00:00,Berlin,314,188,1321,15260,36.0
2020-10-02 00:00:00+00:00,Berlin,341,208,1456,15601,40.0
2020-10-03 00:00:00+00:00,Berlin,96,209,1469,15697,40.0
2020-10-04 00:00:00+00:00,Berlin,108,221,1550,15805,42.0
2020-10-05 00:00:00+00:00,Berlin,314,237,1663,16119,45.0
2020-10-06 00:00:00+00:00,Berlin,321,252,1768,16440,48.0
2020-10-07 00:00:00+00:00,Berlin,494,284,1988,16934,54.0
2020-10-08 00:00:00+00:00,Berlin,456,304,2130,17390,58.0
2020-10-09 00:00:00+00:00,Berlin,505,327,2294,17895,63.0
2020-10-10 00:00:00+00:00,Berlin,171,338,2369,18066,65.0
2020-10-11 00:00:00+00:00,Berlin,147,344,2408,18213,66.0
2020-10-12 00:00:00+00:00,Berlin,593,383,2687,18806,73.0
2020-10-13 00:00:00+00:00,Berlin,505,410,2871,19311,78.0
2020-10-14 00:00:00+00:00,Berlin,587,423,2964,19898,81.0
2020-10-15 00:00:00+00:00,Berlin,681,455,3189,20579,87.0
2020-10-16 00:00:00+00:00,Berlin,627,473,3311,21206,90.0
2020-10-17 00:00:00+00:00,Berlin,167,472,3307,21373,90.0
2020-10-18 00:00:00+00:00,Berlin,192,478,3352,21565,91.0
2020-10-19 00:00:00+00:00,Berlin,778,505,3537,22343,96.0
2020-10-20 00:00:00+00:00,Berlin,895,561,3927,23238,107.0
2020-10-21 00:00:00+00:00,Berlin,809,592,4149,24047,113.0
2020-10-22 00:00:00+00:00,Berlin,898,623,4366,24945,119.0
2020-10-23 00:00:00+00:00,Berlin,922,665,4661,25867,127.0
2020-10-24 00:00:00+00:00,Berlin,284,682,4778,26151,130.0
2020-10-25 00:00:00+00:00,Berlin,328,702,4914,26479,134.0
2020-10-26 00:00:00+00:00,Berlin,1020,736,5156,27499,141.0
2020-10-27 00:00:00+00:00,Berlin,1128,769,5389,28627,147.0
2020-10-28 00:00:00+00:00,Berlin,1290,838,5870,29917,160.0
2020-10-29 00:00:00+00:00,Berlin,1049,860,6021,30966,164.0
2020-10-30 00:00:00+00:00,Berlin,1076,882,6175,32042,168.0
2020-10-31 00:00:00+00:00,Berlin,351,891,6242,32393,170.0
2020-11-01 00:00:00+00:00,Berlin,359,896,6273,32752,171.0
2020-11-02 00:00:00+00:00,Berlin,1417,952,6670,34169,182.0
2020-11-03 00:00:00+00:00,Berlin,1329,981,6871,35498,187.0
2020-11-04 00:00:00+00:00,Berlin,1231,973,6812,36729,186.0
2020-11-05 00:00:00+00:00,Berlin,1299,1008,7062,38028,192.0
2020-11-06 00:00:00+00:00,Berlin,1163,1021,7149,39191,195.0
2020-11-07 00:00:00+00:00,Berlin,406,1029,7204,39597,196.0
2020-11-08 00:00:00+00:00,Berlin,290,1019,7135,39887,194.0
2020-11-09 00:00:00+00:00,Berlin,1463,1025,7181,41350,196.0
2020-11-10 00:00:00+00:00,Berlin,1295,1021,7147,42645,195.0
2020-11-11 00:00:00+00:00,Berlin,1674,1084,7590,44319,207.0
2020-11-12 00:00:00+00:00,Berlin,1554,1120,7845,45873,214.0
2020-11-13 00:00:00+00:00,Berlin,1393,1153,8075,47266,220.0
2020-11-14 00:00:00+00:00,Berlin,459,1161,8128,47725,222.0
2020-11-15 00:00:00+00:00,Berlin,588,1203,8426,48313,230.0
2020-11-16 00:00:00+00:00,Berlin,1615,1225,8578,49928,234.0
2020-11-17 00:00:00+00:00,Berlin,1679,1280,8962,51607,244.0
2020-11-18 00:00:00+00:00,Berlin,1340,1232,8628,52947,235.0
2020-11-19 00:00:00+00:00,Berlin,1437,1215,8511,54384,232.0
2020-11-20 00:00:00+00:00,Berlin,1477,1227,8595,55861,234.0
2020-11-21 00:00:00+00:00,Berlin,455,1227,8591,56316,234.0
2020-11-22 00:00:00+00:00,Berlin,389,1198,8392,56705,229.0
2020-11-23 00:00:00+00:00,Berlin,1602,1197,8379,58307,228.0
2020-11-24 00:00:00+00:00,Berlin,1491,1170,8191,59798,223.0
2020-11-25 00:00:00+00:00,Berlin,1263,1159,8114,61061,221.0
2020-11-26 00:00:00+00:00,Berlin,1321,1142,7998,62382,218.0
2020-11-27 00:00:00+00:00,Berlin,1305,1118,7826,63687,213.0
2020-11-28 00:00:00+00:00,Berlin,487,1122,7858,64174,214.0
2020-11-29 00:00:00+00:00,Berlin,270,1105,7739,64444,211.0
2020-11-30 00:00:00+00:00,Berlin,1188,1046,7325,65632,200.0
2020-12-01 00:00:00+00:00,Berlin,1101,990,6935,66733,189.0
2020-12-02 00:00:00+00:00,Berlin,1165,976,6837,67898,186.0
2020-12-03 00:00:00+00:00,Berlin,1408,989,6924,69306,189.0
2020-12-04 00:00:00+00:00,Berlin,1457,1010,7076,70763,193.0
2020-12-05 00:00:00+00:00,Berlin,432,1003,7021,71195,191.0
2020-12-06 00:00:00+00:00,Berlin,330,1011,7081,71525,193.0
2020-12-07 00:00:00+00:00,Berlin,1335,1032,7228,72860,197.0
2020-12-08 00:00:00+00:00,Berlin,1209,1048,7336,74069,200.0
2020-12-09 00:00:00+00:00,Berlin,1433,1086,7604,75502,207.0
2020-12-10 00:00:00+00:00,Berlin,1427,1089,7623,76929,208.0
2020-12-11 00:00:00+00:00,Berlin,1324,1070,7490,78253,204.0
2020-12-12 00:00:00+00:00,Berlin,466,1074,7524,78719,205.0
2020-12-13 00:00:00+00:00,Berlin,303,1071,7497,79022,204.0
2020-12-14 00:00:00+00:00,Berlin,1537,1099,7699,80559,210.0
2020-12-15 00:00:00+00:00,Berlin,1190,1097,7680,81749,209.0
2020-12-16 00:00:00+00:00,Berlin,1564,1115,7811,83313,213.0
2020-12-17 00:00:00+00:00,Berlin,1662,1149,8046,84975,219.0
2020-12-18 00:00:00+00:00,Berlin,1530,1178,8252,86505,225.0
2020-12-19 00:00:00+00:00,Berlin,501,1183,8287,87006,226.0
2020-12-20 00:00:00+00:00,Berlin,347,1190,8331,87353,227.0
2020-12-21 00:00:00+00:00,Berlin,1576,1195,8370,88929,228.0
2020-12-22 00:00:00+00:00,Berlin,1444,1232,8624,90373,235.0
2020-12-23 00:00:00+00:00,Berlin,1576,1233,8636,91949,235.0
2020-12-24 00:00:00+00:00,Berlin,593,1081,7567,92542,206.0
2020-12-25 00:00:00+00:00,Berlin,179,888,6216,92721,169.0
2020-12-26 00:00:00+00:00,Berlin,695,915,6410,93416,175.0
2020-12-27 00:00:00+00:00,Berlin,483,935,6546,93899,178.0
2020-12-28 00:00:00+00:00,Berlin,1146,873,6116,95045,167.0
2020-12-29 00:00:00+00:00,Berlin,1213,840,5885,96258,160.0
2020-12-30 00:00:00+00:00,Berlin,1050,765,5359,97308,146.0
2020-12-31 00:00:00+00:00,Berlin,483,749,5249,97791,143.0
2021-01-01 00:00:00+00:00,Berlin,273,763,5343,98064,146.0
2021-01-02 00:00:00+00:00,Berlin,480,732,5128,98544,140.0
2021-01-03 00:00:00+00:00,Berlin,460,729,5105,99004,139.0
2021-01-04 00:00:00+00:00,Berlin,1016,710,4975,100020,136.0
2021-01-05 00:00:00+00:00,Berlin,1181,706,4943,101201,135.0
2021-01-06 00:00:00+00:00,Berlin,1371,752,5264,102572,143.0
2021-01-07 00:00:00+00:00,Berlin,1639,917,6420,104211,175.0
2021-01-08 00:00:00+00:00,Berlin,1272,1059,7419,105483,202.0
2021-01-09 00:00:00+00:00,Berlin,423,1051,7362,105906,201.0
2021-01-10 00:00:00+00:00,Berlin,224,1018,7126,106130,194.0
2021-01-11 00:00:00+00:00,Berlin,1356,1066,7466,107486,203.0
2021-01-12 00:00:00+00:00,Berlin,1175,1065,7460,108661,203.0
2021-01-13 00:00:00+00:00,Berlin,1184,1039,7273,109845,198.0
2021-01-14 00:00:00+00:00,Berlin,1008,948,6642,110853,181.0
2021-01-15 00:00:00+00:00,Berlin,885,893,6255,111738,170.0
2021-01-16 00:00:00+00:00,Berlin,294,875,6126,112032,167.0
2021-01-17 00:00:00+00:00,Berlin,166,866,6068,112198,165.0
2021-01-18 00:00:00+00:00,Berlin,662,767,5374,112860,146.0
2021-01-19 00:00:00+00:00,Berlin,892,727,5091,113752,139.0
2021-01-20 00:00:00+00:00,Berlin,861,681,4768,114613,130.0
2021-01-21 00:00:00+00:00,Berlin,663,631,4423,115276,121.0
2021-01-22 00:00:00+00:00,Berlin,663,600,4201,115939,114.0
2021-01-23 00:00:00+00:00,Berlin,267,596,4174,116206,114.0
2021-01-24 00:00:00+00:00,Berlin,56,580,4064,116262,111.0
2021-01-25 00:00:00+00:00,Berlin,607,572,4009,116869,109.0
2021-01-26 00:00:00+00:00,Berlin,687,543,3804,117556,104.0
2021-01-27 00:00:00+00:00,Berlin,653,513,3596,118209,98.0
2021-01-28 00:00:00+00:00,Berlin,492,489,3425,118701,93.0
2021-01-29 00:00:00+00:00,Berlin,511,467,3273,119212,89.0
2021-01-30 00:00:00+00:00,Berlin,176,454,3182,119388,87.0
2021-01-31 00:00:00+00:00,Berlin,56,454,3182,119444,87.0
2021-02-01 00:00:00+00:00,Berlin,621,456,3196,120065,87.0
2021-02-02 00:00:00+00:00,Berlin,509,431,3018,120574,82.0
2021-02-03 00:00:00+00:00,Berlin,485,407,2850,121059,78.0
2021-02-04 00:00:00+00:00,Berlin,431,398,2789,121490,76.0
2021-02-05 00:00:00+00:00,Berlin,390,381,2668,121880,73.0
2021-02-06 00:00:00+00:00,Berlin,198,384,2690,122078,73.0
2021-02-07 00:00:00+00:00,Berlin,25,379,2659,122103,72.0
2021-02-08 00:00:00+00:00,Berlin,417,350,2455,122520,67.0
2021-02-09 00:00:00+00:00,Berlin,461,343,2407,122981,66.0
2021-02-10 00:00:00+00:00,Berlin,420,334,2342,123401,64.0
2021-02-11 00:00:00+00:00,Berlin,379,327,2290,123780,62.0
2021-02-12 00:00:00+00:00,Berlin,335,319,2235,124115,61.0
2021-02-13 00:00:00+00:00,Berlin,97,304,2134,124212,58.0
2021-02-14 00:00:00+00:00,Berlin,35,306,2144,124247,58.0
2021-02-15 00:00:00+00:00,Berlin,385,301,2112,124632,58.0
2021-02-16 00:00:00+00:00,Berlin,371,288,2022,125003,55.0
2021-02-17 00:00:00+00:00,Berlin,446,292,2048,125449,56.0
2021-02-18 00:00:00+00:00,Berlin,383,293,2052,125832,56.0
2021-02-19 00:00:00+00:00,Berlin,372,298,2089,126204,57.0
2021-02-20 00:00:00+00:00,Berlin,175,309,2167,126379,59.0
2021-02-21 00:00:00+00:00,Berlin,11,306,2143,126390,58.0
2021-02-22 00:00:00+00:00,Berlin,421,311,2179,126811,59.0
2021-02-23 00:00:00+00:00,Berlin,475,326,2283,127286,62.0
2021-02-24 00:00:00+00:00,Berlin,483,331,2320,127769,63.0
2021-02-25 00:00:00+00:00,Berlin,460,342,2397,128229,65.0
2021-02-26 00:00:00+00:00,Berlin,475,357,2500,128704,68.0
2021-02-27 00:00:00+00:00,Berlin,133,351,2458,128837,67.0
2021-02-28 00:00:00+00:00,Berlin,29,353,2476,128866,67.0
2021-03-01 00:00:00+00:00,Berlin,511,366,2566,129377,70.0
2021-03-02 00:00:00+00:00,Berlin,500,370,2591,129877,71.0
2021-03-03 00:00:00+00:00,Berlin,516,374,2624,130393,72.0
2021-03-04 00:00:00+00:00,Berlin,444,372,2608,130837,71.0
2021-03-05 00:00:00+00:00,Berlin,438,367,2571,131275,70.0
2021-03-06 00:00:00+00:00,Berlin,167,372,2605,131442,71.0
2021-03-07 00:00:00+00:00,Berlin,88,380,2664,131530,73.0
2021-03-08 00:00:00+00:00,Berlin,74,318,2227,131604,61.0
2021-03-09 00:00:00+00:00,Berlin,475,314,2202,132079,60.0
2021-03-10 00:00:00+00:00,Berlin,608,327,2294,132687,63.0
2021-03-11 00:00:00+00:00,Berlin,674,360,2524,133361,69.0
2021-03-12 00:00:00+00:00,Berlin,683,395,2769,134044,75.0
2021-03-13 00:00:00+00:00,Berlin,267,409,2869,134311,78.0
2021-03-14 00:00:00+00:00,Berlin,67,406,2848,134378,78.0
2021-03-15 00:00:00+00:00,Berlin,681,493,3455,135059,94.0
2021-03-16 00:00:00+00:00,Berlin,647,518,3627,135706,99.0
2021-03-17 00:00:00+00:00,Berlin,750,538,3769,136456,103.0
2021-03-18 00:00:00+00:00,Berlin,761,550,3856,137217,105.0
2021-03-19 00:00:00+00:00,Berlin,628,543,3801,137845,104.0
2021-03-20 00:00:00+00:00,Berlin,257,541,3791,138102,103.0
2021-03-21 00:00:00+00:00,Berlin,81,543,3805,138183,104.0
2021-03-22 00:00:00+00:00,Berlin,915,577,4039,139098,110.0
2021-03-23 00:00:00+00:00,Berlin,1106,642,4498,140204,123.0
2021-03-24 00:00:00+00:00,Berlin,1001,678,4749,141205,129.0
2021-03-25 00:00:00+00:00,Berlin,940,704,4928,142145,134.0
2021-03-26 00:00:00+00:00,Berlin,983,754,5283,143128,144.0
2021-03-27 00:00:00+00:00,Berlin,468,784,5494,143596,150.0
2021-03-28 00:00:00+00:00,Berlin,102,787,5515,143698,150.0
2021-03-29 00:00:00+00:00,Berlin,784,769,5384,144482,147.0
2021-03-30 00:00:00+00:00,Berlin,951,747,5229,145433,142.0
2021-03-31 00:00:00+00:00,Berlin,1110,762,5338,146543,145.0
2021-04-01 00:00:00+00:00,Berlin,917,759,5315,147460,145.0
2021-04-02 00:00:00+00:00,Berlin,354,669,4686,147814,128.0
2021-04-03 00:00:00+00:00,Berlin,675,699,4893,148489,133.0
2021-04-04 00:00:00+00:00,Berlin,176,709,4967,148665,135.0
2021-04-05 00:00:00+00:00,Berlin,329,644,4512,148994,123.0
2021-04-06 00:00:00+00:00,Berlin,623,597,4184,149617,114.0
2021-04-07 00:00:00+00:00,Berlin,744,545,3818,150361,104.0
2021-04-08 00:00:00+00:00,Berlin,949,550,3850,151310,105.0
2021-04-09 00:00:00+00:00,Berlin,1096,656,4592,152406,125.0
2021-04-10 00:00:00+00:00,Berlin,492,629,4409,152898,120.0
2021-04-11 00:00:00+00:00,Berlin,100,619,4333,152998,118.0
2021-04-12 00:00:00+00:00,Berlin,815,688,4819,153813,131.0
2021-04-13 00:00:00+00:00,Berlin,1097,756,5293,154910,144.0
2021-04-14 00:00:00+00:00,Berlin,1250,828,5799,156160,158.0
2021-04-15 00:00:00+00:00,Berlin,1090,848,5940,157250,162.0
2021-04-16 00:00:00+00:00,Berlin,945,827,5789,158195,158.0
2021-04-17 00:00:00+00:00,Berlin,386,811,5683,158581,155.0
2021-04-18 00:00:00+00:00,Berlin,110,813,5693,158691,155.0
2021-04-19 00:00:00+00:00,Berlin,840,816,5718,159531,156.0
2021-04-20 00:00:00+00:00,Berlin,1030,807,5651,160561,154.0
2021-04-21 00:00:00+00:00,Berlin,1185,798,5586,161746,152.0
2021-04-22 00:00:00+00:00,Berlin,890,769,5386,162636,147.0
2021-04-23 00:00:00+00:00,Berlin,814,750,5255,163450,143.0
2021-04-24 00:00:00+00:00,Berlin,429,756,5298,163879,144.0
2021-04-25 00:00:00+00:00,Berlin,97,755,5285,163976,144.0
2021-04-26 00:00:00+00:00,Berlin,923,766,5368,164899,146.0
2021-04-27 00:00:00+00:00,Berlin,977,759,5315,165876,145.0
2021-04-28 00:00:00+00:00,Berlin,885,716,5015,166761,137.0
2021-04-29 00:00:00+00:00,Berlin,779,700,4904,167540,134.0
2021-04-30 00:00:00+00:00,Berlin,679,681,4769,168219,130.0
2021-05-01 00:00:00+00:00,Berlin,221,651,4561,168440,124.0
2021-05-02 00:00:00+00:00,Berlin,33,642,4497,168473,123.0
2021-05-03 00:00:00+00:00,Berlin,702,610,4276,169175,117.0
2021-05-04 00:00:00+00:00,Berlin,787,583,4086,169962,111.0
2021-05-05 00:00:00+00:00,Berlin,817,574,4018,170779,109.0
2021-05-06 00:00:00+00:00,Berlin,602,548,3841,171381,105.0
2021-05-07 00:00:00+00:00,Berlin,610,538,3772,171991,103.0
2021-05-08 00:00:00+00:00,Berlin,195,535,3746,172186,102.0
2021-05-09 00:00:00+00:00,Berlin,25,534,3738,172211,102.0
2021-05-10 00:00:00+00:00,Berlin,556,513,3592,172767,98.0
2021-05-11 00:00:00+00:00,Berlin,518,474,3323,173285,91.0
2021-05-12 00:00:00+00:00,Berlin,678,454,3184,173963,87.0
2021-05-13 00:00:00+00:00,Berlin,128,387,2710,174091,74.0
2021-05-14 00:00:00+00:00,Berlin,433,361,2533,174524,69.0
2021-05-15 00:00:00+00:00,Berlin,178,359,2516,174702,69.0
2021-05-16 00:00:00+00:00,Berlin,34,360,2525,174736,69.0
2021-05-17 00:00:00+00:00,Berlin,415,340,2384,175151,65.0
2021-05-18 00:00:00+00:00,Berlin,490,336,2356,175641,64.0
2021-05-19 00:00:00+00:00,Berlin,440,302,2118,176081,58.0
2021-05-20 00:00:00+00:00,Berlin,256,320,2246,176337,61.0
2021-05-21 00:00:00+00:00,Berlin,326,305,2139,176663,58.0
2021-05-22 00:00:00+00:00,Berlin,104,295,2065,176767,56.0
2021-05-23 00:00:00+00:00,Berlin,26,293,2057,176793,56.0
2021-05-24 00:00:00+00:00,Berlin,78,245,1720,176871,47.0
2021-05-25 00:00:00+00:00,Berlin,240,210,1470,177111,40.0
2021-05-26 00:00:00+00:00,Berlin,296,189,1326,177407,36.0
2021-05-27 00:00:00+00:00,Berlin,269,191,1339,177676,36.0
2021-05-28 00:00:00+00:00,Berlin,242,179,1255,177918,34.0
2021-05-29 00:00:00+00:00,Berlin,62,173,1213,177980,33.0
2021-05-30 00:00:00+00:00,Berlin,8,170,1195,177988,33.0
2021-05-31 00:00:00+00:00,Berlin,202,188,1319,178190,36.0
2021-06-01 00:00:00+00:00,Berlin,176,179,1255,178366,34.0
2021-06-02 00:00:00+00:00,Berlin,213,167,1172,178579,32.0
2021-06-03 00:00:00+00:00,Berlin,226,161,1129,178805,31.0
2021-06-04 00:00:00+00:00,Berlin,149,148,1036,178954,28.0
2021-06-05 00:00:00+00:00,Berlin,27,143,1001,178981,27.0
2021-06-06 00:00:00+00:00,Berlin,6,142,999,178987,27.0
2021-06-07 00:00:00+00:00,Berlin,119,130,916,179106,25.0
2021-06-08 00:00:00+00:00,Berlin,113,121,853,179219,23.0
2021-06-09 00:00:00+00:00,Berlin,123,109,763,179342,21.0
2021-06-10 00:00:00+00:00,Berlin,106,91,643,179448,18.0
2021-06-11 00:00:00+00:00,Berlin,89,83,583,179537,16.0
2021-06-12 00:00:00+00:00,Berlin,11,81,567,179548,15.0
2021-06-13 00:00:00+00:00,Berlin,5,80,566,179553,15.0
2021-06-14 00:00:00+00:00,Berlin,62,72,509,179615,14.0
2021-06-15 00:00:00+00:00,Berlin,60,65,456,179675,12.0
2021-06-16 00:00:00+00:00,Berlin,70,57,403,179745,11.0
2021-06-17 00:00:00+00:00,Berlin,26,46,323,179771,9.0
2021-06-18 00:00:00+00:00,Berlin,49,40,283,179820,8.0
2021-06-19 00:00:00+00:00,Berlin,17,41,289,179837,8.0
2021-06-20 00:00:00+00:00,Berlin,1,40,285,179838,8.0
2021-06-21 00:00:00+00:00,Berlin,58,40,281,179896,8.0
2021-06-22 00:00:00+00:00,Berlin,45,38,266,179941,7.0
2021-06-23 00:00:00+00:00,Berlin,54,35,250,179995,7.0
2021-06-24 00:00:00+00:00,Berlin,45,38,269,180040,7.0
2021-06-25 00:00:00+00:00,Berlin,40,37,260,180080,7.0
2021-06-26 00:00:00+00:00,Berlin,7,35,250,180087,7.0
2021-06-28 00:00:00+00:00,Berlin,37,40,286,180124,8.0
2021-06-29 00:00:00+00:00,Berlin,46,39,274,180170,7.0
2021-06-30 00:00:00+00:00,Berlin,35,37,264,180205,7.0
2021-07-01 00:00:00+00:00,Berlin,33,34,243,180238,7.0
2021-07-02 00:00:00+00:00,Berlin,32,32,230,180270,6.0
2021-07-03 00:00:00+00:00,Berlin,2,27,192,180272,5.0
2021-07-04 00:00:00+00:00,Berlin,2,26,187,180274,5.0
2021-07-05 00:00:00+00:00,Berlin,51,28,201,180325,5.0
2021-07-06 00:00:00+00:00,Berlin,45,28,200,180370,5.0
2020-02-29 00:00:00+00:00,Hamburg,1,0,0,1,0.0
2020-03-01 00:00:00+00:00,Hamburg,1,0,0,2,0.0
2020-03-03 00:00:00+00:00,Hamburg,3,0,0,5,0.0
2020-03-04 00:00:00+00:00,Hamburg,1,0,0,6,0.0
2020-03-05 00:00:00+00:00,Hamburg,5,0,0,11,0.0
2020-03-06 00:00:00+00:00,Hamburg,3,0,0,14,0.0
2020-03-07 00:00:00+00:00,Hamburg,4,2,18,18,1.0
2020-03-08 00:00:00+00:00,Hamburg,5,3,22,23,1.0
2020-03-09 00:00:00+00:00,Hamburg,21,6,42,44,2.0
2020-03-10 00:00:00+00:00,Hamburg,29,9,68,73,4.0
2020-03-11 00:00:00+00:00,Hamburg,30,13,97,103,5.0
2020-03-12 00:00:00+00:00,Hamburg,41,19,133,144,7.0
2020-03-13 00:00:00+00:00,Hamburg,38,24,168,182,9.0
2020-03-14 00:00:00+00:00,Hamburg,79,34,243,261,13.0
2020-03-15 00:00:00+00:00,Hamburg,78,45,316,339,17.0
2020-03-16 00:00:00+00:00,Hamburg,80,53,375,419,20.0
2020-03-17 00:00:00+00:00,Hamburg,133,68,479,552,26.0
2020-03-18 00:00:00+00:00,Hamburg,135,83,584,687,32.0
2020-03-19 00:00:00+00:00,Hamburg,186,104,729,873,39.0
2020-03-20 00:00:00+00:00,Hamburg,146,119,837,1019,45.0
2020-03-21 00:00:00+00:00,Hamburg,106,123,864,1125,47.0
2020-03-22 00:00:00+00:00,Hamburg,149,133,935,1274,51.0
2020-03-23 00:00:00+00:00,Hamburg,132,141,987,1406,53.0
2020-03-24 00:00:00+00:00,Hamburg,206,151,1060,1612,57.0
2020-03-25 00:00:00+00:00,Hamburg,162,155,1087,1774,59.0
2020-03-26 00:00:00+00:00,Hamburg,171,153,1072,1945,58.0
2020-03-27 00:00:00+00:00,Hamburg,142,152,1068,2087,58.0
2020-03-28 00:00:00+00:00,Hamburg,145,158,1107,2232,60.0
2020-03-29 00:00:00+00:00,Hamburg,115,153,1073,2347,58.0
2020-03-30 00:00:00+00:00,Hamburg,71,144,1012,2418,55.0
2020-03-31 00:00:00+00:00,Hamburg,159,137,965,2577,52.0
2020-04-01 00:00:00+00:00,Hamburg,139,134,942,2716,51.0
2020-04-02 00:00:00+00:00,Hamburg,166,133,937,2882,51.0
2020-04-03 00:00:00+00:00,Hamburg,158,136,953,3040,52.0
2020-04-04 00:00:00+00:00,Hamburg,109,131,917,3149,50.0
2020-04-05 00:00:00+00:00,Hamburg,108,130,910,3257,49.0
2020-04-06 00:00:00+00:00,Hamburg,93,133,932,3350,50.0
2020-04-07 00:00:00+00:00,Hamburg,209,140,982,3559,53.0
2020-04-08 00:00:00+00:00,Hamburg,118,137,961,3677,52.0
2020-04-09 00:00:00+00:00,Hamburg,113,129,908,3790,49.0
2020-04-10 00:00:00+00:00,Hamburg,97,121,847,3887,46.0
2020-04-11 00:00:00+00:00,Hamburg,79,116,817,3966,44.0
2020-04-12 00:00:00+00:00,Hamburg,46,107,755,4012,41.0
2020-04-13 00:00:00+00:00,Hamburg,41,100,703,4053,38.0
2020-04-14 00:00:00+00:00,Hamburg,77,81,571,4130,31.0
2020-04-15 00:00:00+00:00,Hamburg,84,76,537,4214,29.0
2020-04-16 00:00:00+00:00,Hamburg,73,71,497,4287,27.0
2020-04-17 00:00:00+00:00,Hamburg,107,72,507,4394,27.0
2020-04-18 00:00:00+00:00,Hamburg,39,66,467,4433,25.0
2020-04-19 00:00:00+00:00,Hamburg,22,63,443,4455,24.0
2020-04-20 00:00:00+00:00,Hamburg,33,62,435,4488,24.0
2020-04-21 00:00:00+00:00,Hamburg,57,59,415,4545,22.0
2020-04-22 00:00:00+00:00,Hamburg,50,54,381,4595,21.0
2020-04-23 00:00:00+00:00,Hamburg,49,51,357,4644,19.0
2020-04-24 00:00:00+00:00,Hamburg,41,41,291,4685,16.0
2020-04-25 00:00:00+00:00,Hamburg,44,42,296,4729,16.0
2020-04-26 00:00:00+00:00,Hamburg,17,41,291,4746,16.0
2020-04-27 00:00:00+00:00,Hamburg,21,39,279,4767,15.0
2020-04-28 00:00:00+00:00,Hamburg,25,35,247,4792,13.0
2020-04-29 00:00:00+00:00,Hamburg,42,34,239,4834,13.0
2020-04-30 00:00:00+00:00,Hamburg,25,30,215,4859,12.0
2020-05-01 00:00:00+00:00,Hamburg,9,26,183,4868,10.0
2020-05-02 00:00:00+00:00,Hamburg,13,21,152,4881,8.0
2020-05-03 00:00:00+00:00,Hamburg,3,19,138,4884,7.0
2020-05-04 00:00:00+00:00,Hamburg,9,18,126,4893,7.0
2020-05-05 00:00:00+00:00,Hamburg,21,17,122,4914,7.0
2020-05-06 00:00:00+00:00,Hamburg,22,14,102,4936,6.0
2020-05-07 00:00:00+00:00,Hamburg,17,13,94,4953,5.0
2020-05-08 00:00:00+00:00,Hamburg,12,13,97,4965,5.0
2020-05-09 00:00:00+00:00,Hamburg,10,13,94,4975,5.0
2020-05-10 00:00:00+00:00,Hamburg,3,13,94,4978,5.0
2020-05-11 00:00:00+00:00,Hamburg,4,12,89,4982,5.0
2020-05-12 00:00:00+00:00,Hamburg,2,10,70,4984,4.0
2020-05-13 00:00:00+00:00,Hamburg,14,8,62,4998,3.0
2020-05-14 00:00:00+00:00,Hamburg,10,7,55,5008,3.0
2020-05-15 00:00:00+00:00,Hamburg,12,7,55,5020,3.0
2020-05-16 00:00:00+00:00,Hamburg,6,7,51,5026,3.0
2020-05-17 00:00:00+00:00,Hamburg,1,7,49,5027,3.0
2020-05-18 00:00:00+00:00,Hamburg,1,6,46,5028,2.0
2020-05-19 00:00:00+00:00,Hamburg,3,6,47,5031,3.0
2020-05-20 00:00:00+00:00,Hamburg,13,6,46,5044,2.0
2020-05-21 00:00:00+00:00,Hamburg,2,5,38,5046,2.0
2020-05-22 00:00:00+00:00,Hamburg,3,4,29,5049,2.0
2020-05-23 00:00:00+00:00,Hamburg,3,3,26,5052,1.0
2020-05-25 00:00:00+00:00,Hamburg,1,3,26,5053,1.0
2020-05-26 00:00:00+00:00,Hamburg,3,4,28,5056,2.0
2020-05-27 00:00:00+00:00,Hamburg,1,3,26,5057,1.0
2020-05-29 00:00:00+00:00,Hamburg,5,2,18,5062,1.0
2020-05-30 00:00:00+00:00,Hamburg,1,2,17,5063,1.0
2020-05-31 00:00:00+00:00,Hamburg,6,2,20,5069,1.0
2020-06-01 00:00:00+00:00,Hamburg,2,2,19,5071,1.0
2020-06-02 00:00:00+00:00,Hamburg,2,2,20,5073,1.0
2020-06-03 00:00:00+00:00,Hamburg,10,3,27,5083,1.0
2020-06-04 00:00:00+00:00,Hamburg,6,4,32,5089,2.0
2020-06-05 00:00:00+00:00,Hamburg,5,4,32,5094,2.0
2020-06-06 00:00:00+00:00,Hamburg,1,4,32,5095,2.0
2020-06-07 00:00:00+00:00,Hamburg,1,3,27,5096,1.0
2020-06-08 00:00:00+00:00,Hamburg,3,4,28,5099,2.0
2020-06-09 00:00:00+00:00,Hamburg,2,4,28,5101,2.0
2020-06-10 00:00:00+00:00,Hamburg,4,3,22,5105,1.0
2020-06-11 00:00:00+00:00,Hamburg,7,3,23,5112,1.0
2020-06-12 00:00:00+00:00,Hamburg,4,3,22,5116,1.0
2020-06-13 00:00:00+00:00,Hamburg,3,3,24,5119,1.0
2020-06-14 00:00:00+00:00,Hamburg,1,3,24,5120,1.0
2020-06-15 00:00:00+00:00,Hamburg,1,3,22,5121,1.0
2020-06-16 00:00:00+00:00,Hamburg,3,3,23,5124,1.0
2020-06-17 00:00:00+00:00,Hamburg,7,3,26,5131,1.0
2020-06-18 00:00:00+00:00,Hamburg,8,3,27,5139,1.0
2020-06-19 00:00:00+00:00,Hamburg,4,3,27,5143,1.0
2020-06-20 00:00:00+00:00,Hamburg,4,4,28,5147,2.0
2020-06-21 00:00:00+00:00,Hamburg,4,4,31,5151,2.0
2020-06-22 00:00:00+00:00,Hamburg,3,4,33,5154,2.0
2020-06-23 00:00:00+00:00,Hamburg,10,5,40,5164,2.0
2020-06-24 00:00:00+00:00,Hamburg,12,6,45,5176,2.0
2020-06-25 00:00:00+00:00,Hamburg,4,5,41,5180,2.0
2020-06-26 00:00:00+00:00,Hamburg,10,6,47,5190,3.0
2020-06-27 00:00:00+00:00,Hamburg,2,6,45,5192,2.0
2020-06-28 00:00:00+00:00,Hamburg,7,6,48,5199,3.0
2020-06-29 00:00:00+00:00,Hamburg,1,6,46,5200,2.0
2020-06-30 00:00:00+00:00,Hamburg,3,5,39,5203,2.0
2020-07-01 00:00:00+00:00,Hamburg,9,5,36,5212,2.0
2020-07-02 00:00:00+00:00,Hamburg,4,5,36,5216,2.0
2020-07-03 00:00:00+00:00,Hamburg,2,4,28,5218,2.0
2020-07-04 00:00:00+00:00,Hamburg,1,3,27,5219,1.0
2020-07-05 00:00:00+00:00,Hamburg,3,3,23,5222,1.0
2020-07-06 00:00:00+00:00,Hamburg,3,3,25,5225,1.0
2020-07-07 00:00:00+00:00,Hamburg,4,3,26,5229,1.0
2020-07-08 00:00:00+00:00,Hamburg,3,2,20,5232,1.0
2020-07-09 00:00:00+00:00,Hamburg,2,2,18,5234,1.0
2020-07-10 00:00:00+00:00,Hamburg,2,2,18,5236,1.0
2020-07-13 00:00:00+00:00,Hamburg,1,2,18,5237,1.0
2020-07-14 00:00:00+00:00,Hamburg,2,2,17,5239,1.0
2020-07-15 00:00:00+00:00,Hamburg,1,2,15,5240,1.0
2020-07-16 00:00:00+00:00,Hamburg,6,2,17,5246,1.0
2020-07-17 00:00:00+00:00,Hamburg,4,2,18,5250,1.0
2020-07-18 00:00:00+00:00,Hamburg,1,2,17,5251,1.0
2020-07-19 00:00:00+00:00,Hamburg,2,2,17,5253,1.0
2020-07-20 00:00:00+00:00,Hamburg,5,3,21,5258,1.0
2020-07-21 00:00:00+00:00,Hamburg,9,4,28,5267,2.0
2020-07-22 00:00:00+00:00,Hamburg,24,7,51,5291,3.0
2020-07-23 00:00:00+00:00,Hamburg,12,8,57,5303,3.0
2020-07-24 00:00:00+00:00,Hamburg,22,10,75,5325,4.0
2020-07-25 00:00:00+00:00,Hamburg,15,12,89,5340,5.0
2020-07-26 00:00:00+00:00,Hamburg,4,13,91,5344,5.0
2020-07-27 00:00:00+00:00,Hamburg,7,13,93,5351,5.0
2020-07-28 00:00:00+00:00,Hamburg,15,14,99,5366,5.0
2020-07-29 00:00:00+00:00,Hamburg,30,15,105,5396,6.0
2020-07-30 00:00:00+00:00,Hamburg,21,16,114,5417,6.0
2020-07-31 00:00:00+00:00,Hamburg,19,15,111,5436,6.0
2020-08-01 00:00:00+00:00,Hamburg,17,16,113,5453,6.0
2020-08-02 00:00:00+00:00,Hamburg,6,16,115,5459,6.0
2020-08-03 00:00:00+00:00,Hamburg,43,21,151,5502,8.0
2020-08-04 00:00:00+00:00,Hamburg,36,24,172,5538,9.0
2020-08-05 00:00:00+00:00,Hamburg,58,28,200,5596,11.0
2020-08-06 00:00:00+00:00,Hamburg,60,34,239,5656,13.0
2020-08-07 00:00:00+00:00,Hamburg,34,36,254,5690,14.0
2020-08-08 00:00:00+00:00,Hamburg,34,38,271,5724,15.0
2020-08-09 00:00:00+00:00,Hamburg,14,39,279,5738,15.0
2020-08-10 00:00:00+00:00,Hamburg,34,38,270,5772,15.0
2020-08-11 00:00:00+00:00,Hamburg,29,37,263,5801,14.0
2020-08-12 00:00:00+00:00,Hamburg,48,36,253,5849,14.0
2020-08-13 00:00:00+00:00,Hamburg,26,31,219,5875,12.0
2020-08-14 00:00:00+00:00,Hamburg,34,31,219,5909,12.0
2020-08-15 00:00:00+00:00,Hamburg,10,27,195,5919,11.0
2020-08-16 00:00:00+00:00,Hamburg,8,27,189,5927,10.0
2020-08-17 00:00:00+00:00,Hamburg,17,24,172,5944,9.0
2020-08-18 00:00:00+00:00,Hamburg,32,25,175,5976,9.0
2020-08-19 00:00:00+00:00,Hamburg,35,23,162,6011,9.0
2020-08-20 00:00:00+00:00,Hamburg,29,23,165,6040,9.0
2020-08-21 00:00:00+00:00,Hamburg,34,23,165,6074,9.0
2020-08-22 00:00:00+00:00,Hamburg,16,24,171,6090,9.0
2020-08-23 00:00:00+00:00,Hamburg,22,26,185,6112,10.0
2020-08-24 00:00:00+00:00,Hamburg,26,27,194,6138,11.0
2020-08-25 00:00:00+00:00,Hamburg,32,27,194,6170,11.0
2020-08-26 00:00:00+00:00,Hamburg,30,27,189,6200,10.0
2020-08-27 00:00:00+00:00,Hamburg,18,25,178,6218,10.0
2020-08-28 00:00:00+00:00,Hamburg,38,26,182,6256,10.0
2020-08-29 00:00:00+00:00,Hamburg,40,29,206,6296,11.0
2020-08-30 00:00:00+00:00,Hamburg,19,29,203,6315,11.0
2020-08-31 00:00:00+00:00,Hamburg,27,29,204,6342,11.0
2020-09-01 00:00:00+00:00,Hamburg,30,28,202,6372,11.0
2020-09-02 00:00:00+00:00,Hamburg,55,32,227,6427,12.0
2020-09-03 00:00:00+00:00,Hamburg,50,37,259,6477,14.0
2020-09-04 00:00:00+00:00,Hamburg,40,37,261,6517,14.0
2020-09-05 00:00:00+00:00,Hamburg,35,36,256,6552,14.0
2020-09-06 00:00:00+00:00,Hamburg,32,38,269,6584,15.0
2020-09-07 00:00:00+00:00,Hamburg,22,37,264,6606,14.0
2020-09-08 00:00:00+00:00,Hamburg,57,41,291,6663,16.0
2020-09-09 00:00:00+00:00,Hamburg,70,43,306,6733,17.0
2020-09-10 00:00:00+00:00,Hamburg,51,43,307,6784,17.0
2020-09-11 00:00:00+00:00,Hamburg,54,45,321,6838,17.0
2020-09-12 00:00:00+00:00,Hamburg,30,45,316,6868,17.0
2020-09-13 00:00:00+00:00,Hamburg,35,45,319,6903,17.0
2020-09-14 00:00:00+00:00,Hamburg,46,49,343,6949,19.0
2020-09-15 00:00:00+00:00,Hamburg,45,47,331,6994,18.0
2020-09-16 00:00:00+00:00,Hamburg,56,45,317,7050,17.0
2020-09-17 00:00:00+00:00,Hamburg,81,49,347,7131,19.0
2020-09-18 00:00:00+00:00,Hamburg,75,52,368,7206,20.0
2020-09-19 00:00:00+00:00,Hamburg,65,57,403,7271,22.0
2020-09-20 00:00:00+00:00,Hamburg,31,57,399,7302,22.0
2020-09-21 00:00:00+00:00,Hamburg,45,56,398,7347,22.0
2020-09-22 00:00:00+00:00,Hamburg,78,61,431,7425,23.0
2020-09-23 00:00:00+00:00,Hamburg,75,64,450,7500,24.0
2020-09-24 00:00:00+00:00,Hamburg,90,65,459,7590,25.0
2020-09-25 00:00:00+00:00,Hamburg,96,68,480,7686,26.0
2020-09-26 00:00:00+00:00,Hamburg,75,70,490,7761,27.0
2020-09-27 00:00:00+00:00,Hamburg,50,72,509,7811,28.0
2020-09-28 00:00:00+00:00,Hamburg,58,74,522,7869,28.0
2020-09-29 00:00:00+00:00,Hamburg,92,76,536,7961,29.0
2020-09-30 00:00:00+00:00,Hamburg,101,80,562,8062,30.0
2020-10-01 00:00:00+00:00,Hamburg,77,78,549,8139,30.0
2020-10-02 00:00:00+00:00,Hamburg,153,86,606,8292,33.0
2020-10-03 00:00:00+00:00,Hamburg,82,87,613,8374,33.0
2020-10-04 00:00:00+00:00,Hamburg,76,91,639,8450,35.0
2020-10-05 00:00:00+00:00,Hamburg,98,97,679,8548,37.0
2020-10-06 00:00:00+00:00,Hamburg,95,97,682,8643,37.0
2020-10-07 00:00:00+00:00,Hamburg,106,98,687,8749,37.0
2020-10-08 00:00:00+00:00,Hamburg,128,105,738,8877,40.0
2020-10-09 00:00:00+00:00,Hamburg,119,100,704,8996,38.0
2020-10-10 00:00:00+00:00,Hamburg,59,97,681,9055,37.0
2020-10-11 00:00:00+00:00,Hamburg,82,98,687,9137,37.0
2020-10-12 00:00:00+00:00,Hamburg,143,104,732,9280,40.0
2020-10-13 00:00:00+00:00,Hamburg,95,104,732,9375,40.0
2020-10-14 00:00:00+00:00,Hamburg,193,117,819,9568,44.0
2020-10-15 00:00:00+00:00,Hamburg,159,121,850,9727,46.0
2020-10-16 00:00:00+00:00,Hamburg,169,128,900,9896,49.0
2020-10-17 00:00:00+00:00,Hamburg,155,142,996,10051,54.0
2020-10-18 00:00:00+00:00,Hamburg,95,144,1009,10146,55.0
2020-10-19 00:00:00+00:00,Hamburg,174,148,1040,10320,56.0
2020-10-20 00:00:00+00:00,Hamburg,229,167,1174,10549,64.0
2020-10-21 00:00:00+00:00,Hamburg,320,185,1301,10869,70.0
2020-10-22 00:00:00+00:00,Hamburg,377,217,1519,11246,82.0
2020-10-23 00:00:00+00:00,Hamburg,416,252,1766,11662,96.0
2020-10-24 00:00:00+00:00,Hamburg,246,265,1857,11908,101.0
2020-10-25 00:00:00+00:00,Hamburg,211,281,1973,12119,107.0
2020-10-26 00:00:00+00:00,Hamburg,318,302,2117,12437,115.0
2020-10-27 00:00:00+00:00,Hamburg,512,342,2400,12949,130.0
2020-10-28 00:00:00+00:00,Hamburg,405,355,2485,13354,135.0
2020-10-29 00:00:00+00:00,Hamburg,495,371,2603,13849,141.0
2020-10-30 00:00:00+00:00,Hamburg,467,379,2654,14316,144.0
2020-10-31 00:00:00+00:00,Hamburg,272,382,2680,14588,145.0
2020-11-01 00:00:00+00:00,Hamburg,224,384,2693,14812,146.0
2020-11-02 00:00:00+00:00,Hamburg,398,396,2773,15210,150.0
2020-11-03 00:00:00+00:00,Hamburg,577,405,2838,15787,154.0
2020-11-04 00:00:00+00:00,Hamburg,522,422,2955,16309,160.0
2020-11-05 00:00:00+00:00,Hamburg,503,423,2963,16812,160.0
2020-11-06 00:00:00+00:00,Hamburg,463,422,2959,17275,160.0
2020-11-07 00:00:00+00:00,Hamburg,416,443,3103,17691,168.0
2020-11-08 00:00:00+00:00,Hamburg,265,449,3144,17956,170.0
2020-11-09 00:00:00+00:00,Hamburg,408,450,3154,18364,171.0
2020-11-10 00:00:00+00:00,Hamburg,569,449,3146,18933,170.0
2020-11-11 00:00:00+00:00,Hamburg,444,438,3068,19377,166.0
2020-11-12 00:00:00+00:00,Hamburg,468,433,3033,19845,164.0
2020-11-13 00:00:00+00:00,Hamburg,446,430,3016,20291,163.0
2020-11-14 00:00:00+00:00,Hamburg,243,406,2843,20534,154.0
2020-11-15 00:00:00+00:00,Hamburg,197,396,2775,20731,150.0
2020-11-16 00:00:00+00:00,Hamburg,350,388,2717,21081,147.0
2020-11-17 00:00:00+00:00,Hamburg,391,362,2539,21472,137.0
2020-11-18 00:00:00+00:00,Hamburg,497,370,2592,21969,140.0
2020-11-19 00:00:00+00:00,Hamburg,432,365,2556,22401,138.0
2020-11-20 00:00:00+00:00,Hamburg,473,369,2583,22874,140.0
2020-11-21 00:00:00+00:00,Hamburg,182,360,2522,23056,137.0
2020-11-22 00:00:00+00:00,Hamburg,140,352,2465,23196,133.0
2020-11-23 00:00:00+00:00,Hamburg,256,338,2371,23452,128.0
2020-11-24 00:00:00+00:00,Hamburg,395,339,2375,23847,129.0
2020-11-25 00:00:00+00:00,Hamburg,302,311,2180,24149,118.0
2020-11-26 00:00:00+00:00,Hamburg,304,293,2052,24453,111.0
2020-11-27 00:00:00+00:00,Hamburg,113,241,1692,24566,92.0
2020-11-28 00:00:00+00:00,Hamburg,103,230,1613,24669,87.0
2020-11-29 00:00:00+00:00,Hamburg,148,231,1621,24817,88.0
2020-11-30 00:00:00+00:00,Hamburg,309,239,1674,25126,91.0
2020-12-01 00:00:00+00:00,Hamburg,332,230,1611,25458,87.0
2020-12-02 00:00:00+00:00,Hamburg,297,229,1606,25755,87.0
2020-12-03 00:00:00+00:00,Hamburg,489,255,1791,26244,97.0
2020-12-04 00:00:00+00:00,Hamburg,354,290,2032,26598,110.0
2020-12-05 00:00:00+00:00,Hamburg,200,304,2129,26798,115.0
2020-12-06 00:00:00+00:00,Hamburg,254,319,2235,27052,121.0
2020-12-07 00:00:00+00:00,Hamburg,271,313,2197,27323,119.0
2020-12-08 00:00:00+00:00,Hamburg,347,316,2212,27670,120.0
2020-12-09 00:00:00+00:00,Hamburg,455,338,2370,28125,128.0
2020-12-10 00:00:00+00:00,Hamburg,455,333,2336,28580,126.0
2020-12-11 00:00:00+00:00,Hamburg,514,356,2496,29094,135.0
2020-12-12 00:00:00+00:00,Hamburg,292,369,2588,29386,140.0
2020-12-13 00:00:00+00:00,Hamburg,291,375,2625,29677,142.0
2020-12-14 00:00:00+00:00,Hamburg,322,382,2676,29999,145.0
2020-12-15 00:00:00+00:00,Hamburg,534,409,2863,30533,155.0
2020-12-16 00:00:00+00:00,Hamburg,495,414,2903,31028,157.0
2020-12-17 00:00:00+00:00,Hamburg,550,428,2998,31578,162.0
2020-12-18 00:00:00+00:00,Hamburg,584,438,3068,32162,166.0
2020-12-19 00:00:00+00:00,Hamburg,375,450,3151,32537,171.0
2020-12-20 00:00:00+00:00,Hamburg,219,439,3079,32756,167.0
2020-12-21 00:00:00+00:00,Hamburg,621,482,3378,33377,183.0
2020-12-22 00:00:00+00:00,Hamburg,629,496,3473,34006,188.0
2020-12-23 00:00:00+00:00,Hamburg,541,502,3519,34547,190.0
2020-12-24 00:00:00+00:00,Hamburg,335,472,3304,34882,179.0
2020-12-25 00:00:00+00:00,Hamburg,215,419,2935,35097,159.0
2020-12-26 00:00:00+00:00,Hamburg,247,401,2807,35344,152.0
2020-12-27 00:00:00+00:00,Hamburg,153,391,2741,35497,148.0
2020-12-28 00:00:00+00:00,Hamburg,486,372,2606,35983,141.0
2020-12-29 00:00:00+00:00,Hamburg,495,353,2472,36478,134.0
2020-12-30 00:00:00+00:00,Hamburg,580,358,2511,37058,136.0
2020-12-31 00:00:00+00:00,Hamburg,343,359,2519,37401,136.0
2021-01-01 00:00:00+00:00,Hamburg,213,359,2517,37614,136.0
2021-01-02 00:00:00+00:00,Hamburg,275,363,2545,37889,138.0
2021-01-03 00:00:00+00:00,Hamburg,202,370,2594,38091,140.0
2021-01-04 00:00:00+00:00,Hamburg,510,374,2618,38601,142.0
2021-01-05 00:00:00+00:00,Hamburg,527,378,2650,39128,143.0
2021-01-06 00:00:00+00:00,Hamburg,486,365,2556,39614,138.0
2021-01-07 00:00:00+00:00,Hamburg,522,390,2735,40136,148.0
2021-01-08 00:00:00+00:00,Hamburg,374,413,2896,40510,157.0
2021-01-09 00:00:00+00:00,Hamburg,206,403,2827,40716,153.0
2021-01-10 00:00:00+00:00,Hamburg,286,415,2911,41002,158.0
2021-01-11 00:00:00+00:00,Hamburg,357,394,2758,41359,149.0
2021-01-12 00:00:00+00:00,Hamburg,390,374,2621,41749,142.0
2021-01-13 00:00:00+00:00,Hamburg,345,354,2480,42094,134.0
2021-01-14 00:00:00+00:00,Hamburg,313,324,2271,42407,123.0
2021-01-15 00:00:00+00:00,Hamburg,388,326,2285,42795,124.0
2021-01-16 00:00:00+00:00,Hamburg,156,319,2235,42951,121.0
2021-01-17 00:00:00+00:00,Hamburg,118,295,2067,43069,112.0
2021-01-18 00:00:00+00:00,Hamburg,292,286,2002,43361,108.0
2021-01-19 00:00:00+00:00,Hamburg,308,274,1920,43669,104.0
2021-01-20 00:00:00+00:00,Hamburg,306,268,1881,43975,102.0
2021-01-21 00:00:00+00:00,Hamburg,284,264,1852,44259,100.0
2021-01-22 00:00:00+00:00,Hamburg,246,244,1710,44505,93.0
2021-01-23 00:00:00+00:00,Hamburg,257,258,1811,44762,98.0
2021-01-24 00:00:00+00:00,Hamburg,159,264,1852,44921,100.0
2021-01-25 00:00:00+00:00,Hamburg,216,253,1776,45137,96.0
2021-01-26 00:00:00+00:00,Hamburg,290,251,1758,45427,95.0
2021-01-27 00:00:00+00:00,Hamburg,312,252,1764,45739,95.0
2021-01-28 00:00:00+00:00,Hamburg,254,247,1734,45993,94.0
2021-01-29 00:00:00+00:00,Hamburg,249,248,1737,46242,94.0
2021-01-30 00:00:00+00:00,Hamburg,142,231,1622,46384,88.0
2021-01-31 00:00:00+00:00,Hamburg,102,223,1565,46486,85.0
2021-02-01 00:00:00+00:00,Hamburg,224,224,1573,46710,85.0
2021-02-02 00:00:00+00:00,Hamburg,226,215,1509,46936,82.0
2021-02-03 00:00:00+00:00,Hamburg,227,203,1424,47163,77.0
2021-02-04 00:00:00+00:00,Hamburg,200,195,1370,47363,74.0
2021-02-05 00:00:00+00:00,Hamburg,193,187,1314,47556,71.0
2021-02-06 00:00:00+00:00,Hamburg,136,186,1308,47692,71.0
2021-02-07 00:00:00+00:00,Hamburg,129,190,1335,47821,72.0
2021-02-08 00:00:00+00:00,Hamburg,201,187,1312,48022,71.0
2021-02-09 00:00:00+00:00,Hamburg,190,182,1276,48212,69.0
2021-02-10 00:00:00+00:00,Hamburg,198,178,1247,48410,68.0
2021-02-11 00:00:00+00:00,Hamburg,203,178,1250,48613,68.0
2021-02-12 00:00:00+00:00,Hamburg,216,181,1273,48829,69.0
2021-02-13 00:00:00+00:00,Hamburg,99,176,1236,48928,67.0
2021-02-14 00:00:00+00:00,Hamburg,165,181,1272,49093,69.0
2021-02-15 00:00:00+00:00,Hamburg,192,180,1263,49285,68.0
2021-02-16 00:00:00+00:00,Hamburg,197,181,1270,49482,69.0
2021-02-17 00:00:00+00:00,Hamburg,238,187,1310,49720,71.0
2021-02-18 00:00:00+00:00,Hamburg,180,183,1287,49900,70.0
2021-02-19 00:00:00+00:00,Hamburg,250,188,1321,50150,72.0
2021-02-20 00:00:00+00:00,Hamburg,144,195,1366,50294,74.0
2021-02-21 00:00:00+00:00,Hamburg,152,193,1353,50446,73.0
2021-02-22 00:00:00+00:00,Hamburg,208,195,1369,50654,74.0
2021-02-23 00:00:00+00:00,Hamburg,273,206,1445,50927,78.0
2021-02-24 00:00:00+00:00,Hamburg,261,209,1468,51188,79.0
2021-02-25 00:00:00+00:00,Hamburg,245,219,1533,51433,83.0
2021-02-26 00:00:00+00:00,Hamburg,203,212,1486,51636,80.0
2021-02-27 00:00:00+00:00,Hamburg,118,208,1460,51754,79.0
2021-02-28 00:00:00+00:00,Hamburg,224,218,1532,51978,83.0
2021-03-01 00:00:00+00:00,Hamburg,216,220,1540,52194,83.0
2021-03-02 00:00:00+00:00,Hamburg,239,215,1506,52433,82.0
2021-03-03 00:00:00+00:00,Hamburg,280,217,1525,52713,83.0
2021-03-04 00:00:00+00:00,Hamburg,229,215,1509,52942,82.0
2021-03-05 00:00:00+00:00,Hamburg,227,219,1533,53169,83.0
2021-03-06 00:00:00+00:00,Hamburg,157,224,1572,53326,85.0
2021-03-07 00:00:00+00:00,Hamburg,167,216,1515,53493,82.0
2021-03-08 00:00:00+00:00,Hamburg,225,217,1524,53718,83.0
2021-03-09 00:00:00+00:00,Hamburg,223,215,1508,53941,82.0
2021-03-10 00:00:00+00:00,Hamburg,290,216,1518,54231,82.0
2021-03-11 00:00:00+00:00,Hamburg,325,230,1614,54556,87.0
2021-03-12 00:00:00+00:00,Hamburg,236,231,1623,54792,88.0
2021-03-13 00:00:00+00:00,Hamburg,187,236,1653,54979,89.0
2021-03-14 00:00:00+00:00,Hamburg,250,248,1736,55229,94.0
2021-03-15 00:00:00+00:00,Hamburg,235,249,1746,55464,95.0
2021-03-16 00:00:00+00:00,Hamburg,430,279,1953,55894,106.0
2021-03-17 00:00:00+00:00,Hamburg,413,296,2076,56307,112.0
2021-03-18 00:00:00+00:00,Hamburg,365,302,2116,56672,115.0
2021-03-19 00:00:00+00:00,Hamburg,316,313,2196,56988,119.0
2021-03-20 00:00:00+00:00,Hamburg,188,313,2197,57176,119.0
2021-03-21 00:00:00+00:00,Hamburg,249,313,2196,57425,119.0
2021-03-22 00:00:00+00:00,Hamburg,295,322,2256,57720,122.0
2021-03-23 00:00:00+00:00,Hamburg,453,325,2279,58173,123.0
2021-03-24 00:00:00+00:00,Hamburg,499,337,2365,58672,128.0
2021-03-25 00:00:00+00:00,Hamburg,600,371,2600,59272,141.0
2021-03-26 00:00:00+00:00,Hamburg,435,388,2719,59707,147.0
2021-03-27 00:00:00+00:00,Hamburg,293,403,2824,60000,153.0
2021-03-28 00:00:00+00:00,Hamburg,292,409,2867,60292,155.0
2021-03-29 00:00:00+00:00,Hamburg,360,418,2932,60652,159.0
2021-03-30 00:00:00+00:00,Hamburg,613,441,3092,61265,167.0
2021-03-31 00:00:00+00:00,Hamburg,528,445,3121,61793,169.0
2021-04-01 00:00:00+00:00,Hamburg,473,427,2994,62266,162.0
2021-04-02 00:00:00+00:00,Hamburg,417,425,2976,62683,161.0
2021-04-03 00:00:00+00:00,Hamburg,279,423,2962,62962,160.0
2021-04-04 00:00:00+00:00,Hamburg,238,415,2908,63200,157.0
2021-04-05 00:00:00+00:00,Hamburg,285,404,2833,63485,153.0
2021-04-06 00:00:00+00:00,Hamburg,321,363,2541,63806,138.0
2021-04-07 00:00:00+00:00,Hamburg,479,356,2492,64285,135.0
2021-04-08 00:00:00+00:00,Hamburg,458,353,2477,64743,134.0
2021-04-09 00:00:00+00:00,Hamburg,467,361,2527,65210,137.0
2021-04-10 00:00:00+00:00,Hamburg,377,375,2625,65587,142.0
2021-04-11 00:00:00+00:00,Hamburg,298,383,2685,65885,145.0
2021-04-12 00:00:00+00:00,Hamburg,290,384,2690,66175,146.0
2021-04-13 00:00:00+00:00,Hamburg,447,402,2816,66622,152.0
2021-04-14 00:00:00+00:00,Hamburg,479,402,2816,67101,152.0
2021-04-15 00:00:00+00:00,Hamburg,410,395,2768,67511,150.0
2021-04-16 00:00:00+00:00,Hamburg,430,390,2731,67941,148.0
2021-04-17 00:00:00+00:00,Hamburg,278,376,2632,68219,142.0
2021-04-18 00:00:00+00:00,Hamburg,266,371,2600,68485,141.0
2021-04-19 00:00:00+00:00,Hamburg,245,365,2555,68730,138.0
2021-04-20 00:00:00+00:00,Hamburg,385,356,2493,69115,135.0
2021-04-21 00:00:00+00:00,Hamburg,448,351,2462,69563,133.0
2021-04-22 00:00:00+00:00,Hamburg,313,337,2365,69876,128.0
2021-04-23 00:00:00+00:00,Hamburg,294,318,2229,70170,121.0
2021-04-24 00:00:00+00:00,Hamburg,284,319,2235,70454,121.0
2021-04-25 00:00:00+00:00,Hamburg,198,309,2167,70652,117.0
2021-04-26 00:00:00+00:00,Hamburg,222,306,2144,70874,116.0
2021-04-27 00:00:00+00:00,Hamburg,327,298,2086,71201,113.0
2021-04-28 00:00:00+00:00,Hamburg,372,287,2010,71573,109.0
2021-04-29 00:00:00+00:00,Hamburg,285,283,1982,71858,107.0
2021-04-30 00:00:00+00:00,Hamburg,297,283,1985,72155,107.0
2021-05-01 00:00:00+00:00,Hamburg,236,276,1937,72391,105.0
2021-05-02 00:00:00+00:00,Hamburg,171,272,1910,72562,103.0
2021-05-03 00:00:00+00:00,Hamburg,228,273,1916,72790,104.0
2021-05-04 00:00:00+00:00,Hamburg,254,263,1843,73044,100.0
2021-05-05 00:00:00+00:00,Hamburg,265,248,1736,73309,94.0
2021-05-06 00:00:00+00:00,Hamburg,287,248,1738,73596,94.0
2021-05-07 00:00:00+00:00,Hamburg,200,234,1641,73796,89.0
2021-05-08 00:00:00+00:00,Hamburg,154,222,1559,73950,84.0
2021-05-09 00:00:00+00:00,Hamburg,173,223,1561,74123,85.0
2021-05-10 00:00:00+00:00,Hamburg,148,211,1481,74271,80.0
2021-05-11 00:00:00+00:00,Hamburg,188,202,1415,74459,77.0
2021-05-12 00:00:00+00:00,Hamburg,192,191,1342,74651,73.0
2021-05-13 00:00:00+00:00,Hamburg,139,170,1194,74790,65.0
2021-05-14 00:00:00+00:00,Hamburg,107,157,1101,74897,60.0
2021-05-15 00:00:00+00:00,Hamburg,89,148,1036,74986,56.0
2021-05-16 00:00:00+00:00,Hamburg,85,135,948,75071,51.0
2021-05-17 00:00:00+00:00,Hamburg,82,126,882,75153,48.0
2021-05-18 00:00:00+00:00,Hamburg,132,118,826,75285,45.0
2021-05-19 00:00:00+00:00,Hamburg,139,110,773,75424,42.0
2021-05-20 00:00:00+00:00,Hamburg,99,104,733,75523,40.0
2021-05-21 00:00:00+00:00,Hamburg,101,103,727,75624,39.0
2021-05-22 00:00:00+00:00,Hamburg,92,104,730,75716,40.0
2021-05-23 00:00:00+00:00,Hamburg,64,101,709,75780,38.0
2021-05-24 00:00:00+00:00,Hamburg,43,95,670,75823,36.0
2021-05-25 00:00:00+00:00,Hamburg,64,86,602,75887,33.0
2021-05-26 00:00:00+00:00,Hamburg,85,78,548,75972,30.0
2021-05-27 00:00:00+00:00,Hamburg,78,75,527,76050,29.0
2021-05-28 00:00:00+00:00,Hamburg,81,72,507,76131,27.0
2021-05-29 00:00:00+00:00,Hamburg,51,66,466,76182,25.0
2021-05-30 00:00:00+00:00,Hamburg,20,60,422,76202,23.0
2021-05-31 00:00:00+00:00,Hamburg,73,64,452,76275,24.0
2021-06-01 00:00:00+00:00,Hamburg,69,65,457,76344,25.0
2021-06-02 00:00:00+00:00,Hamburg,66,62,438,76410,24.0
2021-06-03 00:00:00+00:00,Hamburg,64,60,424,76474,23.0
2021-06-04 00:00:00+00:00,Hamburg,58,57,401,76532,22.0
2021-06-05 00:00:00+00:00,Hamburg,30,54,380,76562,21.0
2021-06-06 00:00:00+00:00,Hamburg,31,55,391,76593,21.0
2021-06-07 00:00:00+00:00,Hamburg,40,51,358,76633,19.0
2021-06-08 00:00:00+00:00,Hamburg,62,50,351,76695,19.0
2021-06-09 00:00:00+00:00,Hamburg,58,49,343,76753,19.0
2021-06-10 00:00:00+00:00,Hamburg,35,44,314,76788,17.0
2021-06-11 00:00:00+00:00,Hamburg,43,42,299,76831,16.0
2021-06-12 00:00:00+00:00,Hamburg,19,41,288,76850,16.0
2021-06-13 00:00:00+00:00,Hamburg,29,40,286,76879,15.0
2021-06-14 00:00:00+00:00,Hamburg,38,40,284,76917,15.0
2021-06-15 00:00:00+00:00,Hamburg,50,38,272,76967,15.0
2021-06-16 00:00:00+00:00,Hamburg,26,34,240,76993,13.0
2021-06-17 00:00:00+00:00,Hamburg,45,35,250,77038,14.0
2021-06-18 00:00:00+00:00,Hamburg,42,35,249,77080,13.0
2021-06-19 00:00:00+00:00,Hamburg,19,35,249,77099,13.0
2021-06-20 00:00:00+00:00,Hamburg,10,32,230,77109,12.0
2021-06-21 00:00:00+00:00,Hamburg,43,33,235,77152,13.0
2021-06-22 00:00:00+00:00,Hamburg,43,32,228,77195,12.0
2021-06-23 00:00:00+00:00,Hamburg,26,32,228,77221,12.0
2021-06-24 00:00:00+00:00,Hamburg,25,29,208,77246,11.0
2021-06-25 00:00:00+00:00,Hamburg,36,28,202,77282,11.0
2021-06-26 00:00:00+00:00,Hamburg,7,27,190,77289,10.0
2021-06-27 00:00:00+00:00,Hamburg,13,27,193,77302,10.0
2021-06-28 00:00:00+00:00,Hamburg,31,25,181,77333,10.0
2021-06-29 00:00:00+00:00,Hamburg,31,24,169,77364,9.0
2021-06-30 00:00:00+00:00,Hamburg,30,24,173,77394,9.0
2021-07-01 00:00:00+00:00,Hamburg,30,25,178,77424,10.0
2021-07-02 00:00:00+00:00,Hamburg,22,23,164,77446,9.0
2021-07-03 00:00:00+00:00,Hamburg,17,24,174,77463,9.0
2021-07-04 00:00:00+00:00,Hamburg,10,24,171,77473,9.0
2021-07-05 00:00:00+00:00,Hamburg,37,25,177,77510,10.0
2020-03-01 00:00:00+00:00,Bremen,1,0,0,1,0.0
2020-03-02 00:00:00+00:00,Bremen,1,0,0,2,0.0
2020-03-03 00:00:00+00:00,Bremen,2,0,0,4,0.0
2020-03-09 00:00:00+00:00,Bremen,7,0,0,11,0.0
2020-03-10 00:00:00+00:00,Bremen,11,0,0,22,0.0
2020-03-11 00:00:00+00:00,Bremen,11,0,0,33,0.0
2020-03-12 00:00:00+00:00,Bremen,7,5,40,40,6.0
2020-03-13 00:00:00+00:00,Bremen,9,6,48,49,7.0
2020-03-14 00:00:00+00:00,Bremen,3,7,50,52,7.0
2020-03-15 00:00:00+00:00,Bremen,3,7,51,55,7.0
2020-03-16 00:00:00+00:00,Bremen,1,6,45,56,7.0
2020-03-17 00:00:00+00:00,Bremen,12,6,46,68,7.0
2020-03-18 00:00:00+00:00,Bremen,10,6,45,78,7.0
2020-03-19 00:00:00+00:00,Bremen,40,11,78,118,11.0
2020-03-20 00:00:00+00:00,Bremen,24,13,93,142,14.0
2020-03-21 00:00:00+00:00,Bremen,22,16,112,164,16.0
2020-03-22 00:00:00+00:00,Bremen,4,16,113,168,17.0
2020-03-23 00:00:00+00:00,Bremen,12,17,124,180,18.0
2020-03-24 00:00:00+00:00,Bremen,19,18,131,199,19.0
2020-03-25 00:00:00+00:00,Bremen,11,18,132,210,19.0
2020-03-26 00:00:00+00:00,Bremen,31,17,123,241,18.0
2020-03-27 00:00:00+00:00,Bremen,20,17,119,261,17.0
2020-03-28 00:00:00+00:00,Bremen,25,17,122,286,18.0
2020-03-29 00:00:00+00:00,Bremen,1,17,119,287,17.0
2020-03-30 00:00:00+00:00,Bremen,8,16,115,295,17.0
2020-03-31 00:00:00+00:00,Bremen,17,16,113,312,17.0
2020-04-01 00:00:00+00:00,Bremen,16,16,118,328,17.0
2020-04-02 00:00:00+00:00,Bremen,11,14,98,339,14.0
2020-04-03 00:00:00+00:00,Bremen,33,15,111,372,16.0
2020-04-04 00:00:00+00:00,Bremen,15,14,101,387,15.0
2020-04-05 00:00:00+00:00,Bremen,3,14,103,390,15.0
2020-04-06 00:00:00+00:00,Bremen,5,14,100,395,15.0
2020-04-07 00:00:00+00:00,Bremen,36,17,119,431,17.0
2020-04-08 00:00:00+00:00,Bremen,6,15,109,437,16.0
2020-04-09 00:00:00+00:00,Bremen,18,16,116,455,17.0
2020-04-10 00:00:00+00:00,Bremen,9,13,92,464,14.0
2020-04-11 00:00:00+00:00,Bremen,13,12,90,477,13.0
2020-04-12 00:00:00+00:00,Bremen,4,13,91,481,13.0
2020-04-13 00:00:00+00:00,Bremen,6,13,92,487,14.0
2020-04-14 00:00:00+00:00,Bremen,7,9,63,494,9.0
2020-04-15 00:00:00+00:00,Bremen,15,10,72,509,11.0
2020-04-16 00:00:00+00:00,Bremen,45,14,99,554,15.0
2020-04-17 00:00:00+00:00,Bremen,12,14,102,566,15.0
2020-04-18 00:00:00+00:00,Bremen,17,15,106,583,16.0
2020-04-19 00:00:00+00:00,Bremen,12,16,114,595,17.0
2020-04-20 00:00:00+00:00,Bremen,7,16,115,602,17.0
2020-04-21 00:00:00+00:00,Bremen,16,17,124,618,18.0
2020-04-22 00:00:00+00:00,Bremen,108,31,217,726,32.0
2020-04-23 00:00:00+00:00,Bremen,17,27,189,743,28.0
2020-04-24 00:00:00+00:00,Bremen,17,27,194,760,28.0
2020-04-25 00:00:00+00:00,Bremen,15,27,192,775,28.0
2020-04-26 00:00:00+00:00,Bremen,14,27,194,789,28.0
2020-04-27 00:00:00+00:00,Bremen,7,27,194,796,28.0
2020-04-28 00:00:00+00:00,Bremen,43,31,221,839,32.0
2020-04-29 00:00:00+00:00,Bremen,42,22,155,881,23.0
2020-04-30 00:00:00+00:00,Bremen,22,22,160,903,23.0
2020-05-01 00:00:00+00:00,Bremen,12,22,155,915,23.0
2020-05-02 00:00:00+00:00,Bremen,3,20,143,918,21.0
2020-05-03 00:00:00+00:00,Bremen,17,20,146,935,21.0
2020-05-04 00:00:00+00:00,Bremen,17,22,156,952,23.0
2020-05-05 00:00:00+00:00,Bremen,10,17,123,962,18.0
2020-05-06 00:00:00+00:00,Bremen,54,19,135,1016,20.0
2020-05-07 00:00:00+00:00,Bremen,29,20,142,1045,21.0
2020-05-08 00:00:00+00:00,Bremen,28,22,158,1073,23.0
2020-05-09 00:00:00+00:00,Bremen,15,24,170,1088,25.0
2020-05-10 00:00:00+00:00,Bremen,12,23,165,1100,24.0
2020-05-11 00:00:00+00:00,Bremen,3,21,151,1103,22.0
2020-05-12 00:00:00+00:00,Bremen,20,23,161,1123,24.0
2020-05-13 00:00:00+00:00,Bremen,29,19,136,1152,20.0
2020-05-14 00:00:00+00:00,Bremen,23,18,130,1175,19.0
2020-05-15 00:00:00+00:00,Bremen,21,17,123,1196,18.0
2020-05-16 00:00:00+00:00,Bremen,19,18,127,1215,19.0
2020-05-17 00:00:00+00:00,Bremen,10,17,125,1225,18.0
2020-05-18 00:00:00+00:00,Bremen,11,19,133,1236,20.0
2020-05-19 00:00:00+00:00,Bremen,19,18,132,1255,19.0
2020-05-20 00:00:00+00:00,Bremen,18,17,121,1273,18.0
2020-05-21 00:00:00+00:00,Bremen,16,16,114,1289,17.0
2020-05-22 00:00:00+00:00,Bremen,4,13,97,1293,14.0
2020-05-23 00:00:00+00:00,Bremen,3,11,81,1296,12.0
2020-05-24 00:00:00+00:00,Bremen,13,12,84,1309,12.0
2020-05-25 00:00:00+00:00,Bremen,2,10,75,1311,11.0
2020-05-26 00:00:00+00:00,Bremen,10,9,66,1321,10.0
2020-05-27 00:00:00+00:00,Bremen,26,10,74,1347,11.0
2020-05-28 00:00:00+00:00,Bremen,26,12,84,1373,12.0
2020-05-29 00:00:00+00:00,Bremen,29,15,109,1402,16.0
2020-05-30 00:00:00+00:00,Bremen,24,18,130,1426,19.0
2020-05-31 00:00:00+00:00,Bremen,8,17,125,1434,18.0
2020-06-01 00:00:00+00:00,Bremen,1,17,124,1435,18.0
2020-06-02 00:00:00+00:00,Bremen,11,17,125,1446,18.0
2020-06-03 00:00:00+00:00,Bremen,18,16,117,1464,17.0
2020-06-04 00:00:00+00:00,Bremen,34,17,125,1498,18.0
2020-06-05 00:00:00+00:00,Bremen,15,15,111,1513,16.0
2020-06-06 00:00:00+00:00,Bremen,5,13,92,1518,14.0
2020-06-07 00:00:00+00:00,Bremen,15,14,99,1533,15.0
2020-06-08 00:00:00+00:00,Bremen,1,14,99,1534,15.0
2020-06-09 00:00:00+00:00,Bremen,15,14,103,1549,15.0
2020-06-10 00:00:00+00:00,Bremen,17,14,102,1566,15.0
2020-06-11 00:00:00+00:00,Bremen,8,10,76,1574,11.0
2020-06-12 00:00:00+00:00,Bremen,8,9,69,1582,10.0
2020-06-13 00:00:00+00:00,Bremen,8,10,72,1590,11.0
2020-06-14 00:00:00+00:00,Bremen,3,8,60,1593,9.0
2020-06-15 00:00:00+00:00,Bremen,1,8,60,1594,9.0
2020-06-16 00:00:00+00:00,Bremen,14,8,59,1608,9.0
2020-06-17 00:00:00+00:00,Bremen,12,7,54,1620,8.0
2020-06-18 00:00:00+00:00,Bremen,7,7,53,1627,8.0
2020-06-19 00:00:00+00:00,Bremen,10,7,55,1637,8.0
2020-06-20 00:00:00+00:00,Bremen,8,7,55,1645,8.0
2020-06-21 00:00:00+00:00,Bremen,3,7,55,1648,8.0
2020-06-22 00:00:00+00:00,Bremen,6,8,60,1654,9.0
2020-06-24 00:00:00+00:00,Bremen,2,6,48,1656,7.0
2020-06-25 00:00:00+00:00,Bremen,3,5,39,1659,6.0
2020-06-26 00:00:00+00:00,Bremen,1,4,33,1660,5.0
2020-06-27 00:00:00+00:00,Bremen,2,3,25,1662,4.0
2020-06-29 00:00:00+00:00,Bremen,1,2,18,1663,3.0
2020-06-30 00:00:00+00:00,Bremen,5,2,20,1668,3.0
2020-07-01 00:00:00+00:00,Bremen,4,2,18,1672,3.0
2020-07-02 00:00:00+00:00,Bremen,4,2,20,1676,3.0
2020-07-04 00:00:00+00:00,Bremen,3,2,20,1679,3.0
2020-07-05 00:00:00+00:00,Bremen,1,2,20,1680,3.0
2020-07-07 00:00:00+00:00,Bremen,2,2,20,1682,3.0
2020-07-08 00:00:00+00:00,Bremen,3,3,22,1685,3.0
2020-07-09 00:00:00+00:00,Bremen,4,3,21,1689,3.0
2020-07-10 00:00:00+00:00,Bremen,1,2,18,1690,3.0
2020-07-12 00:00:00+00:00,Bremen,1,2,15,1691,2.0
2020-07-13 00:00:00+00:00,Bremen,1,1,13,1692,2.0
2020-07-15 00:00:00+00:00,Bremen,6,2,18,1698,3.0
2020-07-16 00:00:00+00:00,Bremen,4,2,20,1702,3.0
2020-07-17 00:00:00+00:00,Bremen,8,3,25,1710,4.0
2020-07-18 00:00:00+00:00,Bremen,9,4,30,1719,4.0
2020-07-19 00:00:00+00:00,Bremen,2,4,31,1721,5.0
2020-07-20 00:00:00+00:00,Bremen,1,4,31,1722,5.0
2020-07-21 00:00:00+00:00,Bremen,4,4,34,1726,5.0
2020-07-22 00:00:00+00:00,Bremen,2,4,30,1728,4.0
2020-07-23 00:00:00+00:00,Bremen,6,4,32,1734,5.0
2020-07-24 00:00:00+00:00,Bremen,9,4,33,1743,5.0
2020-07-25 00:00:00+00:00,Bremen,5,4,29,1748,4.0
2020-07-27 00:00:00+00:00,Bremen,5,4,32,1753,5.0
2020-07-28 00:00:00+00:00,Bremen,6,5,37,1759,5.0
2020-07-29 00:00:00+00:00,Bremen,5,5,38,1764,6.0
2020-07-30 00:00:00+00:00,Bremen,11,6,47,1775,7.0
2020-07-31 00:00:00+00:00,Bremen,7,6,48,1782,7.0
2020-08-01 00:00:00+00:00,Bremen,1,5,40,1783,6.0
2020-08-03 00:00:00+00:00,Bremen,4,5,39,1787,6.0
2020-08-04 00:00:00+00:00,Bremen,4,5,38,1791,6.0
2020-08-05 00:00:00+00:00,Bremen,2,4,34,1793,5.0
2020-08-06 00:00:00+00:00,Bremen,6,5,35,1799,5.0
2020-08-07 00:00:00+00:00,Bremen,2,3,26,1801,4.0
2020-08-08 00:00:00+00:00,Bremen,3,3,22,1804,3.0
2020-08-09 00:00:00+00:00,Bremen,1,3,22,1805,3.0
2020-08-10 00:00:00+00:00,Bremen,8,3,26,1813,4.0
2020-08-11 00:00:00+00:00,Bremen,7,4,29,1820,4.0
2020-08-12 00:00:00+00:00,Bremen,3,4,30,1823,4.0
2020-08-13 00:00:00+00:00,Bremen,6,4,30,1829,4.0
2020-08-14 00:00:00+00:00,Bremen,7,5,35,1836,5.0
2020-08-15 00:00:00+00:00,Bremen,6,5,38,1842,6.0
2020-08-16 00:00:00+00:00,Bremen,4,5,41,1846,6.0
2020-08-17 00:00:00+00:00,Bremen,6,5,39,1852,6.0
2020-08-18 00:00:00+00:00,Bremen,14,6,46,1866,7.0
2020-08-19 00:00:00+00:00,Bremen,12,7,55,1878,8.0
2020-08-20 00:00:00+00:00,Bremen,7,8,56,1885,8.0
2020-08-21 00:00:00+00:00,Bremen,8,8,57,1893,8.0
2020-08-22 00:00:00+00:00,Bremen,7,8,58,1900,9.0
2020-08-23 00:00:00+00:00,Bremen,5,8,59,1905,9.0
2020-08-24 00:00:00+00:00,Bremen,8,8,61,1913,9.0
2020-08-25 00:00:00+00:00,Bremen,11,8,58,1924,9.0
2020-08-26 00:00:00+00:00,Bremen,19,9,65,1943,10.0
2020-08-27 00:00:00+00:00,Bremen,14,10,72,1957,11.0
2020-08-28 00:00:00+00:00,Bremen,21,12,85,1978,12.0
2020-08-29 00:00:00+00:00,Bremen,12,12,90,1990,13.0
2020-08-30 00:00:00+00:00,Bremen,1,12,86,1991,13.0
2020-08-31 00:00:00+00:00,Bremen,8,12,86,1999,13.0
2020-09-01 00:00:00+00:00,Bremen,14,12,89,2013,13.0
2020-09-02 00:00:00+00:00,Bremen,23,13,93,2036,14.0
2020-09-03 00:00:00+00:00,Bremen,11,12,90,2047,13.0
2020-09-04 00:00:00+00:00,Bremen,9,11,78,2056,11.0
2020-09-05 00:00:00+00:00,Bremen,11,11,77,2067,11.0
2020-09-06 00:00:00+00:00,Bremen,3,11,79,2070,12.0
2020-09-07 00:00:00+00:00,Bremen,3,10,74,2073,11.0
2020-09-08 00:00:00+00:00,Bremen,12,10,72,2085,11.0
2020-09-09 00:00:00+00:00,Bremen,9,8,58,2094,9.0
2020-09-10 00:00:00+00:00,Bremen,15,8,62,2109,9.0
2020-09-11 00:00:00+00:00,Bremen,8,8,61,2117,9.0
2020-09-12 00:00:00+00:00,Bremen,12,8,62,2129,9.0
2020-09-13 00:00:00+00:00,Bremen,5,9,64,2134,9.0
2020-09-14 00:00:00+00:00,Bremen,2,9,63,2136,9.0
2020-09-15 00:00:00+00:00,Bremen,18,9,69,2154,10.0
2020-09-16 00:00:00+00:00,Bremen,15,10,75,2169,11.0
2020-09-17 00:00:00+00:00,Bremen,4,9,64,2173,9.0
2020-09-18 00:00:00+00:00,Bremen,13,9,69,2186,10.0
2020-09-19 00:00:00+00:00,Bremen,25,11,82,2211,12.0
2020-09-20 00:00:00+00:00,Bremen,5,11,82,2216,12.0
2020-09-21 00:00:00+00:00,Bremen,5,12,85,2221,12.0
2020-09-22 00:00:00+00:00,Bremen,24,13,91,2245,13.0
2020-09-23 00:00:00+00:00,Bremen,11,12,87,2256,13.0
2020-09-24 00:00:00+00:00,Bremen,22,15,105,2278,15.0
2020-09-25 00:00:00+00:00,Bremen,38,18,130,2316,19.0
2020-09-26 00:00:00+00:00,Bremen,45,21,150,2361,22.0
2020-09-27 00:00:00+00:00,Bremen,6,21,151,2367,22.0
2020-09-28 00:00:00+00:00,Bremen,14,22,160,2381,23.0
2020-09-29 00:00:00+00:00,Bremen,49,26,185,2430,27.0
2020-09-30 00:00:00+00:00,Bremen,36,30,210,2466,31.0
2020-10-01 00:00:00+00:00,Bremen,45,33,233,2511,34.0
2020-10-02 00:00:00+00:00,Bremen,40,33,235,2551,34.0
2020-10-03 00:00:00+00:00,Bremen,52,34,242,2603,36.0
2020-10-04 00:00:00+00:00,Bremen,11,35,247,2614,36.0
2020-10-05 00:00:00+00:00,Bremen,14,35,247,2628,36.0
2020-10-06 00:00:00+00:00,Bremen,72,38,270,2700,40.0
2020-10-07 00:00:00+00:00,Bremen,101,47,335,2801,49.0
2020-10-08 00:00:00+00:00,Bremen,74,52,364,2875,53.0
2020-10-09 00:00:00+00:00,Bremen,63,55,387,2938,57.0
2020-10-10 00:00:00+00:00,Bremen,127,66,462,3065,68.0
2020-10-11 00:00:00+00:00,Bremen,6,65,457,3071,67.0
2020-10-12 00:00:00+00:00,Bremen,34,68,477,3105,70.0
2020-10-13 00:00:00+00:00,Bremen,52,65,457,3157,67.0
2020-10-14 00:00:00+00:00,Bremen,102,65,458,3259,67.0
2020-10-15 00:00:00+00:00,Bremen,102,69,486,3361,71.0
2020-10-16 00:00:00+00:00,Bremen,99,74,522,3460,77.0
2020-10-17 00:00:00+00:00,Bremen,91,69,486,3551,71.0
2020-10-18 00:00:00+00:00,Bremen,23,71,503,3574,74.0
2020-10-19 00:00:00+00:00,Bremen,48,73,517,3622,76.0
2020-10-20 00:00:00+00:00,Bremen,90,79,555,3712,81.0
2020-10-21 00:00:00+00:00,Bremen,138,84,591,3850,87.0
2020-10-22 00:00:00+00:00,Bremen,157,92,646,4007,95.0
2020-10-23 00:00:00+00:00,Bremen,126,96,673,4133,99.0
2020-10-24 00:00:00+00:00,Bremen,182,109,764,4315,112.0
2020-10-25 00:00:00+00:00,Bremen,62,114,803,4377,118.0
2020-10-26 00:00:00+00:00,Bremen,99,122,854,4476,125.0
2020-10-27 00:00:00+00:00,Bremen,192,136,956,4668,140.0
2020-10-28 00:00:00+00:00,Bremen,202,145,1020,4870,150.0
2020-10-29 00:00:00+00:00,Bremen,246,158,1109,5116,163.0
2020-10-30 00:00:00+00:00,Bremen,199,168,1182,5315,174.0
2020-10-31 00:00:00+00:00,Bremen,199,171,1199,5514,176.0
2020-11-01 00:00:00+00:00,Bremen,220,193,1357,5734,199.0
2020-11-02 00:00:00+00:00,Bremen,133,198,1391,5867,204.0
2020-11-03 00:00:00+00:00,Bremen,209,201,1408,6076,207.0
2020-11-04 00:00:00+00:00,Bremen,255,208,1461,6331,214.0
2020-11-05 00:00:00+00:00,Bremen,266,211,1481,6597,217.0
2020-11-06 00:00:00+00:00,Bremen,280,223,1562,6877,229.0
2020-11-07 00:00:00+00:00,Bremen,183,220,1546,7060,227.0
2020-11-08 00:00:00+00:00,Bremen,71,199,1397,7131,205.0
2020-11-09 00:00:00+00:00,Bremen,104,195,1368,7235,201.0
2020-11-10 00:00:00+00:00,Bremen,115,182,1274,7350,187.0
2020-11-11 00:00:00+00:00,Bremen,223,177,1242,7573,182.0
2020-11-12 00:00:00+00:00,Bremen,260,176,1236,7833,181.0
2020-11-13 00:00:00+00:00,Bremen,152,158,1108,7985,163.0
2020-11-14 00:00:00+00:00,Bremen,189,159,1114,8174,164.0
2020-11-15 00:00:00+00:00,Bremen,82,160,1125,8256,165.0
2020-11-16 00:00:00+00:00,Bremen,45,152,1066,8301,156.0
2020-11-17 00:00:00+00:00,Bremen,133,154,1084,8434,159.0
2020-11-18 00:00:00+00:00,Bremen,280,163,1141,8714,167.0
2020-11-19 00:00:00+00:00,Bremen,142,146,1023,8856,150.0
2020-11-20 00:00:00+00:00,Bremen,161,147,1032,9017,151.0
2020-11-21 00:00:00+00:00,Bremen,158,143,1001,9175,147.0
2020-11-22 00:00:00+00:00,Bremen,77,142,996,9252,146.0
2020-11-23 00:00:00+00:00,Bremen,25,139,976,9277,143.0
2020-11-24 00:00:00+00:00,Bremen,145,141,988,9422,145.0
2020-11-25 00:00:00+00:00,Bremen,193,128,901,9615,132.0
2020-11-26 00:00:00+00:00,Bremen,120,125,879,9735,129.0
2020-11-27 00:00:00+00:00,Bremen,114,118,832,9849,122.0
2020-11-28 00:00:00+00:00,Bremen,154,118,828,10003,122.0
2020-11-29 00:00:00+00:00,Bremen,29,111,780,10032,115.0
2020-11-30 00:00:00+00:00,Bremen,32,112,787,10064,116.0
2020-12-01 00:00:00+00:00,Bremen,161,114,803,10225,118.0
2020-12-02 00:00:00+00:00,Bremen,166,110,776,10391,114.0
2020-12-03 00:00:00+00:00,Bremen,82,105,738,10473,108.0
2020-12-04 00:00:00+00:00,Bremen,133,108,757,10606,111.0
2020-12-05 00:00:00+00:00,Bremen,127,104,730,10733,107.0
2020-12-06 00:00:00+00:00,Bremen,58,108,759,10791,111.0
2020-12-07 00:00:00+00:00,Bremen,48,110,775,10839,114.0
2020-12-08 00:00:00+00:00,Bremen,117,104,731,10956,107.0
2020-12-09 00:00:00+00:00,Bremen,210,110,775,11166,114.0
2020-12-10 00:00:00+00:00,Bremen,185,125,878,11351,129.0
2020-12-11 00:00:00+00:00,Bremen,119,123,864,11470,127.0
2020-12-12 00:00:00+00:00,Bremen,171,129,908,11641,133.0
2020-12-13 00:00:00+00:00,Bremen,57,129,907,11698,133.0
2020-12-14 00:00:00+00:00,Bremen,22,125,881,11720,129.0
2020-12-15 00:00:00+00:00,Bremen,131,127,895,11851,131.0
2020-12-16 00:00:00+00:00,Bremen,222,129,907,12073,133.0
2020-12-17 00:00:00+00:00,Bremen,158,125,880,12231,129.0
2020-12-18 00:00:00+00:00,Bremen,121,126,882,12352,129.0
2020-12-19 00:00:00+00:00,Bremen,107,116,818,12459,120.0
2020-12-20 00:00:00+00:00,Bremen,130,127,891,12589,131.0
2020-12-21 00:00:00+00:00,Bremen,49,131,918,12638,135.0
2020-12-22 00:00:00+00:00,Bremen,117,129,904,12755,133.0
2020-12-23 00:00:00+00:00,Bremen,253,133,935,13008,137.0
2020-12-24 00:00:00+00:00,Bremen,79,122,856,13087,126.0
2020-12-25 00:00:00+00:00,Bremen,32,109,767,13119,113.0
2020-12-26 00:00:00+00:00,Bremen,33,99,693,13152,102.0
2020-12-27 00:00:00+00:00,Bremen,38,85,601,13190,88.0
2020-12-28 00:00:00+00:00,Bremen,60,87,612,13250,90.0
2020-12-29 00:00:00+00:00,Bremen,157,93,652,13407,96.0
2020-12-30 00:00:00+00:00,Bremen,156,79,555,13563,81.0
2020-12-31 00:00:00+00:00,Bremen,111,83,587,13674,86.0
2021-01-01 00:00:00+00:00,Bremen,24,82,579,13698,85.0
2021-01-02 00:00:00+00:00,Bremen,13,79,559,13711,82.0
2021-01-03 00:00:00+00:00,Bremen,37,79,558,13748,82.0
2021-01-04 00:00:00+00:00,Bremen,54,78,552,13802,81.0
2021-01-05 00:00:00+00:00,Bremen,104,71,499,13906,73.0
2021-01-06 00:00:00+00:00,Bremen,152,70,495,14058,73.0
2021-01-07 00:00:00+00:00,Bremen,105,69,489,14163,72.0
2021-01-08 00:00:00+00:00,Bremen,80,77,545,14243,80.0
2021-01-09 00:00:00+00:00,Bremen,71,86,603,14314,89.0
2021-01-10 00:00:00+00:00,Bremen,41,86,607,14355,89.0
2021-01-11 00:00:00+00:00,Bremen,40,84,593,14395,87.0
2021-01-12 00:00:00+00:00,Bremen,96,83,585,14491,86.0
2021-01-13 00:00:00+00:00,Bremen,142,82,575,14633,84.0
2021-01-14 00:00:00+00:00,Bremen,71,77,541,14704,79.0
2021-01-15 00:00:00+00:00,Bremen,91,78,552,14795,81.0
2021-01-16 00:00:00+00:00,Bremen,104,83,585,14899,86.0
2021-01-17 00:00:00+00:00,Bremen,38,83,582,14937,85.0
2021-01-18 00:00:00+00:00,Bremen,20,80,562,14957,83.0
2021-01-19 00:00:00+00:00,Bremen,71,76,537,15028,79.0
2021-01-20 00:00:00+00:00,Bremen,124,74,519,15152,76.0
2021-01-21 00:00:00+00:00,Bremen,101,78,549,15253,81.0
2021-01-22 00:00:00+00:00,Bremen,75,76,533,15328,78.0
2021-01-23 00:00:00+00:00,Bremen,75,72,504,15403,74.0
2021-01-24 00:00:00+00:00,Bremen,37,71,503,15440,74.0
2021-01-25 00:00:00+00:00,Bremen,33,73,516,15473,76.0
2021-01-26 00:00:00+00:00,Bremen,87,76,532,15560,78.0
2021-01-27 00:00:00+00:00,Bremen,93,71,501,15653,74.0
2021-01-28 00:00:00+00:00,Bremen,106,72,506,15759,74.0
2021-01-29 00:00:00+00:00,Bremen,138,81,569,15897,84.0
2021-01-30 00:00:00+00:00,Bremen,78,81,572,15975,84.0
2021-01-31 00:00:00+00:00,Bremen,27,80,562,16002,83.0
2021-02-01 00:00:00+00:00,Bremen,40,81,569,16042,84.0
2021-02-02 00:00:00+00:00,Bremen,123,86,605,16165,89.0
2021-02-03 00:00:00+00:00,Bremen,115,89,627,16280,92.0
2021-02-04 00:00:00+00:00,Bremen,91,87,612,16371,90.0
2021-02-05 00:00:00+00:00,Bremen,96,81,570,16467,84.0
2021-02-06 00:00:00+00:00,Bremen,58,78,550,16525,81.0
2021-02-07 00:00:00+00:00,Bremen,43,80,566,16568,83.0
2021-02-08 00:00:00+00:00,Bremen,9,76,535,16577,79.0
2021-02-09 00:00:00+00:00,Bremen,85,71,497,16662,73.0
2021-02-10 00:00:00+00:00,Bremen,75,65,457,16737,67.0
2021-02-11 00:00:00+00:00,Bremen,69,62,435,16806,64.0
2021-02-12 00:00:00+00:00,Bremen,65,57,404,16871,59.0
2021-02-13 00:00:00+00:00,Bremen,44,55,390,16915,57.0
2021-02-14 00:00:00+00:00,Bremen,73,60,420,16988,62.0
2021-02-15 00:00:00+00:00,Bremen,22,61,433,17010,64.0
2021-02-16 00:00:00+00:00,Bremen,98,63,446,17108,65.0
2021-02-17 00:00:00+00:00,Bremen,95,66,466,17203,68.0
2021-02-18 00:00:00+00:00,Bremen,72,67,469,17275,69.0
2021-02-19 00:00:00+00:00,Bremen,97,71,501,17372,74.0
2021-02-20 00:00:00+00:00,Bremen,97,79,554,17469,81.0
2021-02-21 00:00:00+00:00,Bremen,27,72,508,17496,75.0
2021-02-22 00:00:00+00:00,Bremen,38,74,524,17534,77.0
2021-02-23 00:00:00+00:00,Bremen,120,78,546,17654,80.0
2021-02-24 00:00:00+00:00,Bremen,105,79,556,17759,82.0
2021-02-25 00:00:00+00:00,Bremen,82,80,566,17841,83.0
2021-02-26 00:00:00+00:00,Bremen,98,81,567,17939,83.0
2021-02-27 00:00:00+00:00,Bremen,89,79,559,18028,82.0
2021-02-28 00:00:00+00:00,Bremen,48,82,580,18076,85.0
2021-03-01 00:00:00+00:00,Bremen,14,79,556,18090,82.0
2021-03-02 00:00:00+00:00,Bremen,103,77,539,18193,79.0
2021-03-03 00:00:00+00:00,Bremen,92,75,526,18285,77.0
2021-03-04 00:00:00+00:00,Bremen,60,72,504,18345,74.0
2021-03-05 00:00:00+00:00,Bremen,80,69,486,18425,71.0
2021-03-06 00:00:00+00:00,Bremen,55,64,452,18480,66.0
2021-03-07 00:00:00+00:00,Bremen,21,60,425,18501,62.0
2021-03-08 00:00:00+00:00,Bremen,22,61,433,18523,64.0
2021-03-09 00:00:00+00:00,Bremen,81,58,411,18604,60.0
2021-03-10 00:00:00+00:00,Bremen,99,59,418,18703,61.0
2021-03-11 00:00:00+00:00,Bremen,86,63,444,18789,65.0
2021-03-12 00:00:00+00:00,Bremen,90,64,454,18879,67.0
2021-03-13 00:00:00+00:00,Bremen,84,69,483,18963,71.0
2021-03-14 00:00:00+00:00,Bremen,60,74,522,19023,77.0
2021-03-15 00:00:00+00:00,Bremen,52,78,552,19075,81.0
2021-03-16 00:00:00+00:00,Bremen,98,81,569,19173,84.0
2021-03-17 00:00:00+00:00,Bremen,147,88,617,19320,91.0
2021-03-18 00:00:00+00:00,Bremen,135,95,666,19455,98.0
2021-03-19 00:00:00+00:00,Bremen,114,98,690,19569,101.0
2021-03-20 00:00:00+00:00,Bremen,94,100,700,19663,103.0
2021-03-21 00:00:00+00:00,Bremen,62,100,702,19725,103.0
2021-03-22 00:00:00+00:00,Bremen,56,100,706,19781,104.0
2021-03-23 00:00:00+00:00,Bremen,159,109,767,19940,113.0
2021-03-24 00:00:00+00:00,Bremen,185,115,805,20125,118.0
2021-03-25 00:00:00+00:00,Bremen,173,120,843,20298,124.0
2021-03-26 00:00:00+00:00,Bremen,174,129,903,20472,133.0
2021-03-27 00:00:00+00:00,Bremen,117,132,926,20589,136.0
2021-03-28 00:00:00+00:00,Bremen,77,134,941,20666,138.0
2021-03-29 00:00:00+00:00,Bremen,74,137,959,20740,141.0
2021-03-30 00:00:00+00:00,Bremen,139,134,939,20879,138.0
2021-03-31 00:00:00+00:00,Bremen,154,129,908,21033,133.0
2021-04-01 00:00:00+00:00,Bremen,149,126,884,21182,130.0
2021-04-02 00:00:00+00:00,Bremen,148,122,858,21330,126.0
2021-04-03 00:00:00+00:00,Bremen,59,114,800,21389,117.0
2021-04-04 00:00:00+00:00,Bremen,85,115,808,21474,119.0
2021-04-05 00:00:00+00:00,Bremen,56,112,790,21530,116.0
2021-04-06 00:00:00+00:00,Bremen,42,99,693,21572,102.0
2021-04-07 00:00:00+00:00,Bremen,194,104,733,21766,108.0
2021-04-08 00:00:00+00:00,Bremen,234,116,818,22000,120.0
2021-04-09 00:00:00+00:00,Bremen,162,118,832,22162,122.0
2021-04-10 00:00:00+00:00,Bremen,116,127,889,22278,131.0
2021-04-11 00:00:00+00:00,Bremen,95,128,899,22373,132.0
2021-04-12 00:00:00+00:00,Bremen,105,135,948,22478,139.0
2021-04-13 00:00:00+00:00,Bremen,158,152,1064,22636,156.0
2021-04-14 00:00:00+00:00,Bremen,275,163,1145,22911,168.0
2021-04-15 00:00:00+00:00,Bremen,188,157,1099,23099,161.0
2021-04-16 00:00:00+00:00,Bremen,157,156,1094,23256,161.0
2021-04-17 00:00:00+00:00,Bremen,158,162,1136,23414,167.0
2021-04-18 00:00:00+00:00,Bremen,90,161,1131,23504,166.0
2021-04-19 00:00:00+00:00,Bremen,68,156,1094,23572,161.0
2021-04-20 00:00:00+00:00,Bremen,199,162,1135,23771,167.0
2021-04-21 00:00:00+00:00,Bremen,222,154,1082,23993,159.0
2021-04-22 00:00:00+00:00,Bremen,210,157,1104,24203,162.0
2021-04-23 00:00:00+00:00,Bremen,150,156,1097,24353,161.0
2021-04-24 00:00:00+00:00,Bremen,150,155,1089,24503,160.0
2021-04-25 00:00:00+00:00,Bremen,50,149,1049,24553,154.0
2021-04-26 00:00:00+00:00,Bremen,77,151,1058,24630,155.0
2021-04-27 00:00:00+00:00,Bremen,155,144,1014,24785,149.0
2021-04-28 00:00:00+00:00,Bremen,189,140,981,24974,144.0
2021-04-29 00:00:00+00:00,Bremen,154,132,925,25128,136.0
2021-04-30 00:00:00+00:00,Bremen,94,124,869,25222,128.0
2021-05-01 00:00:00+00:00,Bremen,167,126,886,25389,130.0
2021-05-02 00:00:00+00:00,Bremen,37,124,873,25426,128.0
2021-05-03 00:00:00+00:00,Bremen,39,119,835,25465,123.0
2021-05-04 00:00:00+00:00,Bremen,153,119,833,25618,122.0
2021-05-05 00:00:00+00:00,Bremen,164,115,808,25782,119.0
2021-05-06 00:00:00+00:00,Bremen,102,108,756,25884,111.0
2021-05-07 00:00:00+00:00,Bremen,81,106,743,25965,109.0
2021-05-08 00:00:00+00:00,Bremen,89,95,665,26054,98.0
2021-05-09 00:00:00+00:00,Bremen,36,94,664,26090,97.0
2021-05-10 00:00:00+00:00,Bremen,26,93,651,26116,96.0
2021-05-11 00:00:00+00:00,Bremen,98,85,596,26214,87.0
2021-05-12 00:00:00+00:00,Bremen,115,78,547,26329,80.0
2021-05-13 00:00:00+00:00,Bremen,44,69,489,26373,72.0
2021-05-14 00:00:00+00:00,Bremen,39,63,447,26412,66.0
2021-05-15 00:00:00+00:00,Bremen,55,59,413,26467,61.0
2021-05-16 00:00:00+00:00,Bremen,41,59,418,26508,61.0
2021-05-17 00:00:00+00:00,Bremen,27,59,419,26535,62.0
2021-05-18 00:00:00+00:00,Bremen,79,57,400,26614,59.0
2021-05-19 00:00:00+00:00,Bremen,91,53,376,26705,55.0
2021-05-20 00:00:00+00:00,Bremen,63,56,395,26768,58.0
2021-05-21 00:00:00+00:00,Bremen,44,57,400,26812,59.0
2021-05-22 00:00:00+00:00,Bremen,32,53,377,26844,55.0
2021-05-23 00:00:00+00:00,Bremen,15,50,351,26859,52.0
2021-05-24 00:00:00+00:00,Bremen,16,48,340,26875,50.0
2021-05-25 00:00:00+00:00,Bremen,19,40,280,26894,41.0
2021-05-26 00:00:00+00:00,Bremen,37,32,226,26931,33.0
2021-05-27 00:00:00+00:00,Bremen,52,30,215,26983,32.0
2021-05-28 00:00:00+00:00,Bremen,35,29,206,27018,30.0
2021-05-29 00:00:00+00:00,Bremen,42,30,216,27060,32.0
2021-05-30 00:00:00+00:00,Bremen,12,30,213,27072,31.0
2021-05-31 00:00:00+00:00,Bremen,10,29,207,27082,30.0
2021-06-01 00:00:00+00:00,Bremen,45,33,233,27127,34.0
2021-06-02 00:00:00+00:00,Bremen,20,30,216,27147,32.0
2021-06-03 00:00:00+00:00,Bremen,41,29,205,27188,30.0
2021-06-04 00:00:00+00:00,Bremen,24,27,194,27212,28.0
2021-06-05 00:00:00+00:00,Bremen,19,24,171,27231,25.0
2021-06-06 00:00:00+00:00,Bremen,10,24,169,27241,25.0
2021-06-07 00:00:00+00:00,Bremen,2,23,161,27243,24.0
2021-06-08 00:00:00+00:00,Bremen,33,21,149,27276,22.0
2021-06-09 00:00:00+00:00,Bremen,12,20,141,27288,21.0
2021-06-10 00:00:00+00:00,Bremen,21,17,121,27309,18.0
2021-06-11 00:00:00+00:00,Bremen,20,16,117,27329,17.0
2021-06-12 00:00:00+00:00,Bremen,6,14,104,27335,15.0
2021-06-13 00:00:00+00:00,Bremen,4,14,98,27339,14.0
2021-06-14 00:00:00+00:00,Bremen,3,14,99,27342,15.0
2021-06-15 00:00:00+00:00,Bremen,9,10,75,27351,11.0
2021-06-16 00:00:00+00:00,Bremen,9,10,72,27360,11.0
2021-06-17 00:00:00+00:00,Bremen,6,8,57,27366,8.0
2021-06-18 00:00:00+00:00,Bremen,6,6,43,27372,6.0
2021-06-19 00:00:00+00:00,Bremen,4,5,41,27376,6.0
2021-06-20 00:00:00+00:00,Bremen,3,5,40,27379,6.0
2021-06-21 00:00:00+00:00,Bremen,5,6,42,27384,6.0
2021-06-22 00:00:00+00:00,Bremen,16,7,49,27400,7.0
2021-06-23 00:00:00+00:00,Bremen,9,7,49,27409,7.0
2021-06-24 00:00:00+00:00,Bremen,9,7,52,27418,8.0
2021-06-25 00:00:00+00:00,Bremen,5,7,51,27423,7.0
2021-06-26 00:00:00+00:00,Bremen,1,6,48,27424,7.0
2021-06-27 00:00:00+00:00,Bremen,1,6,46,27425,7.0
2021-06-28 00:00:00+00:00,Bremen,1,6,42,27426,6.0
2021-06-29 00:00:00+00:00,Bremen,15,5,41,27441,6.0
2021-06-30 00:00:00+00:00,Bremen,10,6,42,27451,6.0
2021-07-01 00:00:00+00:00,Bremen,9,6,42,27460,6.0
2021-07-02 00:00:00+00:00,Bremen,7,6,44,27467,6.0
2021-07-03 00:00:00+00:00,Bremen,5,6,48,27472,7.0
2021-07-04 00:00:00+00:00,Bremen,4,7,51,27476,7.0
2021-07-05 00:00:00+00:00,Bremen,6,8,56,27482,8.0
2021-07-06 00:00:00+00:00,Bremen,18,8,59,27500,9.0
2020-03-02 00:00:00+00:00,Sachsen,1,0,0,1,0.0
2020-03-06 00:00:00+00:00,Sachsen,2,0,0,3,0.0
2020-03-07 00:00:00+00:00,Sachsen,2,0,0,5,0.0
2020-03-08 00:00:00+00:00,Sachsen,5,0,0,10,0.0
2020-03-09 00:00:00+00:00,Sachsen,5,0,0,15,0.0
2020-03-10 00:00:00+00:00,Sachsen,22,0,0,37,0.0
2020-03-11 00:00:00+00:00,Sachsen,17,7,54,54,1.0
2020-03-12 00:00:00+00:00,Sachsen,27,11,80,81,2.0
2020-03-13 00:00:00+00:00,Sachsen,37,16,115,118,3.0
2020-03-14 00:00:00+00:00,Sachsen,34,21,147,152,4.0
2020-03-15 00:00:00+00:00,Sachsen,30,24,172,182,4.0
2020-03-16 00:00:00+00:00,Sachsen,42,29,209,224,5.0
2020-03-17 00:00:00+00:00,Sachsen,87,39,274,311,7.0
2020-03-18 00:00:00+00:00,Sachsen,134,55,391,445,10.0
2020-03-19 00:00:00+00:00,Sachsen,155,74,519,600,13.0
2020-03-20 00:00:00+00:00,Sachsen,143,89,625,743,15.0
2020-03-21 00:00:00+00:00,Sachsen,129,102,720,872,18.0
2020-03-22 00:00:00+00:00,Sachsen,52,106,742,924,18.0
2020-03-23 00:00:00+00:00,Sachsen,125,117,825,1049,20.0
2020-03-24 00:00:00+00:00,Sachsen,160,128,898,1209,22.0
2020-03-25 00:00:00+00:00,Sachsen,181,135,945,1390,23.0
2020-03-26 00:00:00+00:00,Sachsen,170,137,960,1560,24.0
2020-03-27 00:00:00+00:00,Sachsen,188,143,1005,1748,25.0
2020-03-28 00:00:00+00:00,Sachsen,163,148,1039,1911,26.0
2020-03-29 00:00:00+00:00,Sachsen,71,151,1058,1982,26.0
2020-03-30 00:00:00+00:00,Sachsen,141,153,1074,2123,26.0
2020-03-31 00:00:00+00:00,Sachsen,182,156,1096,2305,27.0
2020-04-01 00:00:00+00:00,Sachsen,185,157,1100,2490,27.0
2020-04-02 00:00:00+00:00,Sachsen,225,165,1155,2715,28.0
2020-04-03 00:00:00+00:00,Sachsen,252,174,1219,2967,30.0
2020-04-04 00:00:00+00:00,Sachsen,140,170,1196,3107,29.0
2020-04-05 00:00:00+00:00,Sachsen,69,170,1194,3176,29.0
2020-04-06 00:00:00+00:00,Sachsen,83,162,1136,3259,28.0
2020-04-07 00:00:00+00:00,Sachsen,142,156,1096,3401,27.0
2020-04-08 00:00:00+00:00,Sachsen,159,152,1070,3560,26.0
2020-04-09 00:00:00+00:00,Sachsen,101,135,946,3661,23.0
2020-04-10 00:00:00+00:00,Sachsen,130,117,824,3791,20.0
2020-04-11 00:00:00+00:00,Sachsen,80,109,764,3871,19.0
2020-04-12 00:00:00+00:00,Sachsen,88,111,783,3959,19.0
2020-04-13 00:00:00+00:00,Sachsen,40,105,740,3999,18.0
2020-04-14 00:00:00+00:00,Sachsen,73,95,671,4072,16.0
2020-04-15 00:00:00+00:00,Sachsen,58,81,570,4130,14.0
2020-04-16 00:00:00+00:00,Sachsen,102,81,571,4232,14.0
2020-04-17 00:00:00+00:00,Sachsen,44,69,485,4276,12.0
2020-04-18 00:00:00+00:00,Sachsen,47,64,452,4323,11.0
2020-04-19 00:00:00+00:00,Sachsen,23,55,387,4346,10.0
2020-04-20 00:00:00+00:00,Sachsen,33,54,380,4379,9.0
2020-04-21 00:00:00+00:00,Sachsen,49,50,356,4428,9.0
2020-04-22 00:00:00+00:00,Sachsen,50,49,348,4478,9.0
2020-04-23 00:00:00+00:00,Sachsen,34,40,280,4512,7.0
2020-04-24 00:00:00+00:00,Sachsen,45,40,281,4557,7.0
2020-04-25 00:00:00+00:00,Sachsen,22,36,256,4579,6.0
2020-04-26 00:00:00+00:00,Sachsen,20,36,253,4599,6.0
2020-04-27 00:00:00+00:00,Sachsen,21,34,241,4620,6.0
2020-04-28 00:00:00+00:00,Sachsen,35,32,227,4655,6.0
2020-04-29 00:00:00+00:00,Sachsen,40,31,217,4695,5.0
2020-04-30 00:00:00+00:00,Sachsen,35,31,218,4730,5.0
2020-05-01 00:00:00+00:00,Sachsen,22,27,195,4752,5.0
2020-05-02 00:00:00+00:00,Sachsen,22,27,195,4774,5.0
2020-05-03 00:00:00+00:00,Sachsen,10,26,185,4784,5.0
2020-05-04 00:00:00+00:00,Sachsen,7,24,171,4791,4.0
2020-05-05 00:00:00+00:00,Sachsen,63,28,199,4854,5.0
2020-05-06 00:00:00+00:00,Sachsen,36,27,195,4890,5.0
2020-05-07 00:00:00+00:00,Sachsen,34,27,194,4924,5.0
2020-05-08 00:00:00+00:00,Sachsen,46,31,218,4970,5.0
2020-05-09 00:00:00+00:00,Sachsen,23,31,219,4993,5.0
2020-05-10 00:00:00+00:00,Sachsen,8,31,217,5001,5.0
2020-05-11 00:00:00+00:00,Sachsen,21,33,231,5022,6.0
2020-05-12 00:00:00+00:00,Sachsen,25,27,193,5047,5.0
2020-05-13 00:00:00+00:00,Sachsen,36,27,193,5083,5.0
2020-05-14 00:00:00+00:00,Sachsen,38,28,197,5121,5.0
2020-05-15 00:00:00+00:00,Sachsen,21,24,172,5142,4.0
2020-05-16 00:00:00+00:00,Sachsen,15,23,164,5157,4.0
2020-05-17 00:00:00+00:00,Sachsen,3,22,159,5160,4.0
2020-05-18 00:00:00+00:00,Sachsen,18,22,156,5178,4.0
2020-05-19 00:00:00+00:00,Sachsen,32,23,163,5210,4.0
2020-05-20 00:00:00+00:00,Sachsen,30,22,157,5240,4.0
2020-05-21 00:00:00+00:00,Sachsen,11,18,130,5251,3.0
2020-05-22 00:00:00+00:00,Sachsen,6,16,115,5257,3.0
2020-05-23 00:00:00+00:00,Sachsen,5,15,105,5262,3.0
2020-05-24 00:00:00+00:00,Sachsen,5,15,107,5267,3.0
2020-05-25 00:00:00+00:00,Sachsen,9,14,98,5276,2.0
2020-05-26 00:00:00+00:00,Sachsen,15,11,81,5291,2.0
2020-05-27 00:00:00+00:00,Sachsen,19,10,70,5310,2.0
2020-05-28 00:00:00+00:00,Sachsen,13,10,72,5323,2.0
2020-05-29 00:00:00+00:00,Sachsen,10,10,76,5333,2.0
2020-05-30 00:00:00+00:00,Sachsen,5,10,76,5338,2.0
2020-06-02 00:00:00+00:00,Sachsen,2,10,73,5340,2.0
2020-06-03 00:00:00+00:00,Sachsen,9,10,73,5349,2.0
2020-06-04 00:00:00+00:00,Sachsen,6,9,64,5355,2.0
2020-06-05 00:00:00+00:00,Sachsen,5,7,50,5360,1.0
2020-06-06 00:00:00+00:00,Sachsen,6,6,43,5366,1.0
2020-06-08 00:00:00+00:00,Sachsen,3,5,36,5369,1.0
2020-06-09 00:00:00+00:00,Sachsen,7,5,38,5376,1.0
2020-06-10 00:00:00+00:00,Sachsen,3,5,39,5379,1.0
2020-06-11 00:00:00+00:00,Sachsen,1,4,31,5380,1.0
2020-06-12 00:00:00+00:00,Sachsen,4,4,29,5384,1.0
2020-06-14 00:00:00+00:00,Sachsen,1,3,25,5385,1.0
2020-06-15 00:00:00+00:00,Sachsen,1,2,20,5386,0.0
2020-06-16 00:00:00+00:00,Sachsen,10,3,27,5396,1.0
2020-06-17 00:00:00+00:00,Sachsen,33,7,53,5429,1.0
2020-06-18 00:00:00+00:00,Sachsen,14,9,64,5443,2.0
2020-06-19 00:00:00+00:00,Sachsen,10,10,73,5453,2.0
2020-06-20 00:00:00+00:00,Sachsen,6,10,75,5459,2.0
2020-06-21 00:00:00+00:00,Sachsen,5,11,79,5464,2.0
2020-06-22 00:00:00+00:00,Sachsen,6,12,84,5470,2.0
2020-06-23 00:00:00+00:00,Sachsen,9,11,83,5479,2.0
2020-06-24 00:00:00+00:00,Sachsen,1,7,51,5480,1.0
2020-06-25 00:00:00+00:00,Sachsen,5,6,42,5485,1.0
2020-06-27 00:00:00+00:00,Sachsen,1,4,33,5486,1.0
2020-06-28 00:00:00+00:00,Sachsen,2,4,29,5488,1.0
2020-06-29 00:00:00+00:00,Sachsen,3,3,27,5491,1.0
2020-06-30 00:00:00+00:00,Sachsen,4,3,25,5495,1.0
2020-07-01 00:00:00+00:00,Sachsen,1,2,17,5496,0.0
2020-07-02 00:00:00+00:00,Sachsen,4,2,20,5500,0.0
2020-07-03 00:00:00+00:00,Sachsen,2,2,17,5502,0.0
2020-07-06 00:00:00+00:00,Sachsen,4,2,20,5506,0.0
2020-07-07 00:00:00+00:00,Sachsen,3,3,21,5509,1.0
2020-07-08 00:00:00+00:00,Sachsen,3,3,21,5512,1.0
2020-07-09 00:00:00+00:00,Sachsen,3,2,20,5515,0.0
2020-07-10 00:00:00+00:00,Sachsen,2,3,21,5517,1.0
2020-07-11 00:00:00+00:00,Sachsen,2,2,19,5519,0.0
2020-07-13 00:00:00+00:00,Sachsen,2,2,19,5521,0.0
2020-07-14 00:00:00+00:00,Sachsen,5,2,20,5526,0.0
2020-07-15 00:00:00+00:00,Sachsen,3,2,20,5529,0.0
2020-07-16 00:00:00+00:00,Sachsen,3,2,20,5532,0.0
2020-07-17 00:00:00+00:00,Sachsen,4,3,21,5536,1.0
2020-07-19 00:00:00+00:00,Sachsen,1,2,20,5537,0.0
2020-07-20 00:00:00+00:00,Sachsen,11,4,29,5548,1.0
2020-07-21 00:00:00+00:00,Sachsen,5,4,32,5553,1.0
2020-07-22 00:00:00+00:00,Sachsen,2,4,29,5555,1.0
2020-07-23 00:00:00+00:00,Sachsen,7,4,33,5562,1.0
2020-07-24 00:00:00+00:00,Sachsen,4,4,34,5566,1.0
2020-07-25 00:00:00+00:00,Sachsen,1,4,31,5567,1.0
2020-07-26 00:00:00+00:00,Sachsen,1,4,31,5568,1.0
2020-07-27 00:00:00+00:00,Sachsen,9,4,29,5577,1.0
2020-07-28 00:00:00+00:00,Sachsen,3,3,27,5580,1.0
2020-07-29 00:00:00+00:00,Sachsen,7,4,32,5587,1.0
2020-07-30 00:00:00+00:00,Sachsen,3,4,28,5590,1.0
2020-07-31 00:00:00+00:00,Sachsen,5,4,29,5595,1.0
2020-08-01 00:00:00+00:00,Sachsen,3,4,31,5598,1.0
2020-08-02 00:00:00+00:00,Sachsen,2,4,32,5600,1.0
2020-08-03 00:00:00+00:00,Sachsen,13,5,36,5613,1.0
2020-08-04 00:00:00+00:00,Sachsen,14,6,47,5627,1.0
2020-08-05 00:00:00+00:00,Sachsen,14,7,54,5641,1.0
2020-08-06 00:00:00+00:00,Sachsen,42,13,93,5683,2.0
2020-08-07 00:00:00+00:00,Sachsen,9,13,97,5692,2.0
2020-08-08 00:00:00+00:00,Sachsen,13,15,107,5705,3.0
2020-08-09 00:00:00+00:00,Sachsen,2,15,107,5707,3.0
2020-08-10 00:00:00+00:00,Sachsen,17,15,111,5724,3.0
2020-08-11 00:00:00+00:00,Sachsen,18,16,115,5742,3.0
2020-08-12 00:00:00+00:00,Sachsen,19,17,120,5761,3.0
2020-08-13 00:00:00+00:00,Sachsen,17,13,95,5778,2.0
2020-08-14 00:00:00+00:00,Sachsen,14,14,100,5792,2.0
2020-08-15 00:00:00+00:00,Sachsen,2,12,89,5794,2.0
2020-08-16 00:00:00+00:00,Sachsen,2,12,89,5796,2.0
2020-08-17 00:00:00+00:00,Sachsen,12,12,84,5808,2.0
2020-08-18 00:00:00+00:00,Sachsen,18,12,84,5826,2.0
2020-08-19 00:00:00+00:00,Sachsen,19,12,84,5845,2.0
2020-08-20 00:00:00+00:00,Sachsen,15,11,82,5860,2.0
2020-08-21 00:00:00+00:00,Sachsen,16,12,84,5876,2.0
2020-08-22 00:00:00+00:00,Sachsen,11,13,93,5887,2.0
2020-08-23 00:00:00+00:00,Sachsen,6,13,97,5893,2.0
2020-08-24 00:00:00+00:00,Sachsen,20,15,105,5913,3.0
2020-08-25 00:00:00+00:00,Sachsen,26,16,113,5939,3.0
2020-08-26 00:00:00+00:00,Sachsen,33,18,127,5972,3.0
2020-08-27 00:00:00+00:00,Sachsen,26,19,138,5998,3.0
2020-08-28 00:00:00+00:00,Sachsen,22,20,144,6020,4.0
2020-08-29 00:00:00+00:00,Sachsen,9,20,142,6029,3.0
2020-08-30 00:00:00+00:00,Sachsen,3,19,139,6032,3.0
2020-08-31 00:00:00+00:00,Sachsen,59,25,178,6091,4.0
2020-09-01 00:00:00+00:00,Sachsen,37,27,189,6128,5.0
2020-09-02 00:00:00+00:00,Sachsen,30,26,186,6158,5.0
2020-09-03 00:00:00+00:00,Sachsen,32,27,192,6190,5.0
2020-09-04 00:00:00+00:00,Sachsen,28,28,198,6218,5.0
2020-09-05 00:00:00+00:00,Sachsen,12,28,201,6230,5.0
2020-09-06 00:00:00+00:00,Sachsen,3,28,201,6233,5.0
2020-09-07 00:00:00+00:00,Sachsen,27,24,169,6260,4.0
2020-09-08 00:00:00+00:00,Sachsen,44,25,176,6304,4.0
2020-09-09 00:00:00+00:00,Sachsen,43,27,189,6347,5.0
2020-09-10 00:00:00+00:00,Sachsen,46,29,203,6393,5.0
2020-09-11 00:00:00+00:00,Sachsen,69,34,244,6462,6.0
2020-09-12 00:00:00+00:00,Sachsen,41,39,273,6503,7.0
2020-09-13 00:00:00+00:00,Sachsen,14,40,284,6517,7.0
2020-09-14 00:00:00+00:00,Sachsen,47,43,304,6564,7.0
2020-09-15 00:00:00+00:00,Sachsen,58,45,318,6622,8.0
2020-09-16 00:00:00+00:00,Sachsen,56,47,331,6678,8.0
2020-09-17 00:00:00+00:00,Sachsen,76,51,361,6754,9.0
2020-09-18 00:00:00+00:00,Sachsen,66,51,358,6820,9.0
2020-09-19 00:00:00+00:00,Sachsen,48,52,365,6868,9.0
2020-09-20 00:00:00+00:00,Sachsen,24,53,375,6892,9.0
2020-09-21 00:00:00+00:00,Sachsen,48,53,376,6940,9.0
2020-09-22 00:00:00+00:00,Sachsen,66,54,384,7006,9.0
2020-09-23 00:00:00+00:00,Sachsen,80,58,408,7086,10.0
2020-09-24 00:00:00+00:00,Sachsen,105,62,437,7191,11.0
2020-09-25 00:00:00+00:00,Sachsen,49,60,420,7240,10.0
2020-09-26 00:00:00+00:00,Sachsen,44,59,416,7284,10.0
2020-09-27 00:00:00+00:00,Sachsen,22,59,414,7306,10.0
2020-09-28 00:00:00+00:00,Sachsen,48,59,414,7354,10.0
2020-09-29 00:00:00+00:00,Sachsen,68,59,416,7422,10.0
2020-09-30 00:00:00+00:00,Sachsen,77,59,413,7499,10.0
2020-10-01 00:00:00+00:00,Sachsen,78,55,386,7577,9.0
2020-10-02 00:00:00+00:00,Sachsen,93,61,430,7670,11.0
2020-10-03 00:00:00+00:00,Sachsen,75,65,461,7745,11.0
2020-10-04 00:00:00+00:00,Sachsen,11,64,450,7756,11.0
2020-10-05 00:00:00+00:00,Sachsen,98,71,500,7854,12.0
2020-10-06 00:00:00+00:00,Sachsen,169,85,601,8023,15.0
2020-10-07 00:00:00+00:00,Sachsen,183,101,707,8206,17.0
2020-10-08 00:00:00+00:00,Sachsen,250,125,879,8456,22.0
2020-10-09 00:00:00+00:00,Sachsen,175,137,961,8631,24.0
2020-10-10 00:00:00+00:00,Sachsen,166,150,1052,8797,26.0
2020-10-11 00:00:00+00:00,Sachsen,87,161,1128,8884,28.0
2020-10-12 00:00:00+00:00,Sachsen,167,171,1197,9051,29.0
2020-10-13 00:00:00+00:00,Sachsen,322,192,1350,9373,33.0
2020-10-14 00:00:00+00:00,Sachsen,359,218,1526,9732,37.0
2020-10-15 00:00:00+00:00,Sachsen,397,239,1673,10129,41.0
2020-10-16 00:00:00+00:00,Sachsen,332,261,1830,10461,45.0
2020-10-17 00:00:00+00:00,Sachsen,334,285,1998,10795,49.0
2020-10-18 00:00:00+00:00,Sachsen,178,298,2089,10973,51.0
2020-10-19 00:00:00+00:00,Sachsen,307,318,2229,11280,55.0
2020-10-20 00:00:00+00:00,Sachsen,596,357,2503,11876,61.0
2020-10-21 00:00:00+00:00,Sachsen,585,389,2729,12461,67.0
2020-10-22 00:00:00+00:00,Sachsen,659,427,2991,13120,73.0
2020-10-23 00:00:00+00:00,Sachsen,601,465,3260,13721,80.0
2020-10-24 00:00:00+00:00,Sachsen,593,502,3519,14314,86.0
2020-10-25 00:00:00+00:00,Sachsen,256,513,3597,14570,88.0
2020-10-26 00:00:00+00:00,Sachsen,562,550,3852,15132,95.0
2020-10-27 00:00:00+00:00,Sachsen,811,581,4067,15943,100.0
2020-10-28 00:00:00+00:00,Sachsen,1322,686,4804,17265,118.0
2020-10-29 00:00:00+00:00,Sachsen,1237,768,5382,18502,132.0
2020-10-30 00:00:00+00:00,Sachsen,897,811,5678,19399,139.0
2020-10-31 00:00:00+00:00,Sachsen,976,865,6061,20375,149.0
2020-11-01 00:00:00+00:00,Sachsen,391,885,6196,20766,152.0
2020-11-02 00:00:00+00:00,Sachsen,956,941,6590,21722,162.0
2020-11-03 00:00:00+00:00,Sachsen,1190,995,6969,22912,171.0
2020-11-04 00:00:00+00:00,Sachsen,1632,1039,7279,24544,179.0
2020-11-05 00:00:00+00:00,Sachsen,1535,1082,7577,26079,186.0
2020-11-06 00:00:00+00:00,Sachsen,1233,1130,7913,27312,194.0
2020-11-07 00:00:00+00:00,Sachsen,782,1102,7719,28094,190.0
2020-11-08 00:00:00+00:00,Sachsen,491,1117,7819,28585,192.0
2020-11-09 00:00:00+00:00,Sachsen,848,1101,7711,29433,189.0
2020-11-10 00:00:00+00:00,Sachsen,1316,1119,7837,30749,192.0
2020-11-11 00:00:00+00:00,Sachsen,1174,1054,7379,31923,181.0
2020-11-12 00:00:00+00:00,Sachsen,1432,1039,7276,33355,179.0
2020-11-13 00:00:00+00:00,Sachsen,1406,1064,7449,34761,183.0
2020-11-14 00:00:00+00:00,Sachsen,1149,1116,7816,35910,192.0
2020-11-15 00:00:00+00:00,Sachsen,615,1134,7940,36525,195.0
2020-11-16 00:00:00+00:00,Sachsen,1010,1157,8102,37535,199.0
2020-11-17 00:00:00+00:00,Sachsen,1616,1200,8402,39151,206.0
2020-11-18 00:00:00+00:00,Sachsen,1300,1218,8528,40451,209.0
2020-11-19 00:00:00+00:00,Sachsen,1671,1252,8767,42122,215.0
2020-11-20 00:00:00+00:00,Sachsen,1544,1272,8905,43666,219.0
2020-11-21 00:00:00+00:00,Sachsen,1316,1296,9072,44982,223.0
2020-11-22 00:00:00+00:00,Sachsen,799,1322,9256,45781,227.0
2020-11-23 00:00:00+00:00,Sachsen,1176,1346,9422,46957,231.0
2020-11-24 00:00:00+00:00,Sachsen,1688,1356,9494,48645,233.0
2020-11-25 00:00:00+00:00,Sachsen,1834,1432,10028,50479,246.0
2020-11-26 00:00:00+00:00,Sachsen,2264,1517,10621,52743,261.0
2020-11-27 00:00:00+00:00,Sachsen,2105,1597,11182,54848,275.0
2020-11-28 00:00:00+00:00,Sachsen,1574,1634,11440,56422,281.0
2020-11-29 00:00:00+00:00,Sachsen,1032,1667,11673,57454,287.0
2020-11-30 00:00:00+00:00,Sachsen,1578,1725,12075,59032,297.0
2020-12-01 00:00:00+00:00,Sachsen,2289,1810,12676,61321,311.0
2020-12-02 00:00:00+00:00,Sachsen,2375,1888,13217,63696,325.0
2020-12-03 00:00:00+00:00,Sachsen,2778,1961,13731,66474,337.0
2020-12-04 00:00:00+00:00,Sachsen,2333,1994,13959,68807,343.0
2020-12-05 00:00:00+00:00,Sachsen,1720,2015,14105,70527,346.0
2020-12-06 00:00:00+00:00,Sachsen,1282,2050,14355,71809,353.0
2020-12-07 00:00:00+00:00,Sachsen,2089,2123,14866,73898,365.0
2020-12-08 00:00:00+00:00,Sachsen,2447,2146,15024,76345,369.0
2020-12-09 00:00:00+00:00,Sachsen,2962,2230,15611,79307,383.0
2020-12-10 00:00:00+00:00,Sachsen,3327,2308,16160,82634,397.0
2020-12-11 00:00:00+00:00,Sachsen,2638,2352,16465,85272,404.0
2020-12-12 00:00:00+00:00,Sachsen,2786,2504,17531,88058,431.0
2020-12-13 00:00:00+00:00,Sachsen,1572,2545,17821,89630,438.0
2020-12-14 00:00:00+00:00,Sachsen,2901,2661,18633,92531,458.0
2020-12-15 00:00:00+00:00,Sachsen,3353,2791,19539,95884,480.0
2020-12-16 00:00:00+00:00,Sachsen,3470,2863,20047,99354,492.0
2020-12-17 00:00:00+00:00,Sachsen,3411,2875,20131,102765,494.0
2020-12-18 00:00:00+00:00,Sachsen,2930,2917,20423,105695,502.0
2020-12-19 00:00:00+00:00,Sachsen,2554,2884,20191,108249,496.0
2020-12-20 00:00:00+00:00,Sachsen,1904,2931,20523,110153,504.0
2020-12-21 00:00:00+00:00,Sachsen,2524,2878,20146,112677,495.0
2020-12-22 00:00:00+00:00,Sachsen,3776,2938,20569,116453,505.0
2020-12-23 00:00:00+00:00,Sachsen,3756,2979,20855,120209,512.0
2020-12-24 00:00:00+00:00,Sachsen,2726,2881,20170,122935,495.0
2020-12-25 00:00:00+00:00,Sachsen,1344,2654,18584,124279,456.0
2020-12-26 00:00:00+00:00,Sachsen,1734,2537,17764,126013,436.0
2020-12-27 00:00:00+00:00,Sachsen,1574,2490,17434,127587,428.0
2020-12-28 00:00:00+00:00,Sachsen,2231,2448,17141,129818,421.0
2020-12-29 00:00:00+00:00,Sachsen,3624,2427,16989,133442,417.0
2020-12-30 00:00:00+00:00,Sachsen,3207,2348,16440,136649,404.0
2020-12-31 00:00:00+00:00,Sachsen,1925,2234,15639,138574,384.0
2021-01-01 00:00:00+00:00,Sachsen,989,2183,15284,139563,375.0
2021-01-02 00:00:00+00:00,Sachsen,1248,2114,14798,140811,363.0
2021-01-03 00:00:00+00:00,Sachsen,1002,2032,14226,141813,349.0
2021-01-04 00:00:00+00:00,Sachsen,1744,1962,13739,143557,337.0
2021-01-05 00:00:00+00:00,Sachsen,3414,1932,13529,146971,332.0
2021-01-06 00:00:00+00:00,Sachsen,3124,1920,13446,150095,330.0
2021-01-07 00:00:00+00:00,Sachsen,2725,2035,14246,152820,350.0
2021-01-08 00:00:00+00:00,Sachsen,2497,2250,15754,155317,387.0
2021-01-09 00:00:00+00:00,Sachsen,1362,2266,15868,156679,390.0
2021-01-10 00:00:00+00:00,Sachsen,725,2227,15591,157404,383.0
2021-01-11 00:00:00+00:00,Sachsen,1443,2184,15290,158847,375.0
2021-01-12 00:00:00+00:00,Sachsen,2570,2063,14446,161417,355.0
2021-01-13 00:00:00+00:00,Sachsen,2147,1924,13469,163564,331.0
2021-01-14 00:00:00+00:00,Sachsen,1647,1770,12391,165211,304.0
2021-01-15 00:00:00+00:00,Sachsen,1345,1605,11239,166556,276.0
2021-01-16 00:00:00+00:00,Sachsen,988,1552,10865,167544,267.0
2021-01-17 00:00:00+00:00,Sachsen,455,1513,10595,167999,260.0
2021-01-18 00:00:00+00:00,Sachsen,724,1410,9876,168723,243.0
2021-01-19 00:00:00+00:00,Sachsen,1659,1280,8965,170382,220.0
2021-01-20 00:00:00+00:00,Sachsen,1536,1193,8354,171918,205.0
2021-01-21 00:00:00+00:00,Sachsen,1133,1120,7840,173051,193.0
2021-01-22 00:00:00+00:00,Sachsen,1066,1080,7561,174117,186.0
2021-01-23 00:00:00+00:00,Sachsen,765,1048,7338,174882,180.0
2021-01-24 00:00:00+00:00,Sachsen,430,1044,7313,175312,180.0
2021-01-25 00:00:00+00:00,Sachsen,456,1006,7045,175768,173.0
2021-01-26 00:00:00+00:00,Sachsen,1266,950,6652,177034,163.0
2021-01-27 00:00:00+00:00,Sachsen,1190,900,6306,178224,155.0
2021-01-28 00:00:00+00:00,Sachsen,743,845,5916,178967,145.0
2021-01-29 00:00:00+00:00,Sachsen,821,810,5671,179788,139.0
2021-01-30 00:00:00+00:00,Sachsen,601,786,5507,180389,135.0
2021-01-31 00:00:00+00:00,Sachsen,246,760,5323,180635,131.0
2021-02-01 00:00:00+00:00,Sachsen,479,763,5346,181114,131.0
2021-02-02 00:00:00+00:00,Sachsen,970,721,5050,182084,124.0
2021-02-03 00:00:00+00:00,Sachsen,877,676,4737,182961,116.0
2021-02-04 00:00:00+00:00,Sachsen,701,670,4695,183662,115.0
2021-02-05 00:00:00+00:00,Sachsen,662,648,4536,184324,111.0
2021-02-06 00:00:00+00:00,Sachsen,404,619,4339,184728,107.0
2021-02-07 00:00:00+00:00,Sachsen,145,605,4238,184873,104.0
2021-02-08 00:00:00+00:00,Sachsen,227,569,3986,185100,98.0
2021-02-09 00:00:00+00:00,Sachsen,720,533,3736,185820,92.0
2021-02-10 00:00:00+00:00,Sachsen,580,491,3439,186400,84.0
2021-02-11 00:00:00+00:00,Sachsen,570,472,3308,186970,81.0
2021-02-12 00:00:00+00:00,Sachsen,473,445,3119,187443,77.0
2021-02-13 00:00:00+00:00,Sachsen,282,428,2997,187725,74.0
2021-02-14 00:00:00+00:00,Sachsen,128,425,2980,187853,73.0
2021-02-15 00:00:00+00:00,Sachsen,392,449,3145,188245,77.0
2021-02-16 00:00:00+00:00,Sachsen,679,443,3104,188924,76.0
2021-02-17 00:00:00+00:00,Sachsen,642,452,3166,189566,78.0
2021-02-18 00:00:00+00:00,Sachsen,521,445,3117,190087,77.0
2021-02-19 00:00:00+00:00,Sachsen,480,446,3124,190567,77.0
2021-02-20 00:00:00+00:00,Sachsen,447,469,3289,191014,81.0
2021-02-21 00:00:00+00:00,Sachsen,122,469,3283,191136,81.0
2021-02-22 00:00:00+00:00,Sachsen,355,463,3246,191491,80.0
2021-02-23 00:00:00+00:00,Sachsen,785,478,3352,192276,82.0
2021-02-24 00:00:00+00:00,Sachsen,734,492,3444,193010,85.0
2021-02-25 00:00:00+00:00,Sachsen,679,514,3602,193689,88.0
2021-02-26 00:00:00+00:00,Sachsen,534,522,3656,194223,90.0
2021-02-27 00:00:00+00:00,Sachsen,414,517,3623,194637,89.0
2021-02-28 00:00:00+00:00,Sachsen,155,522,3656,194792,90.0
2021-03-01 00:00:00+00:00,Sachsen,363,523,3664,195155,90.0
2021-03-02 00:00:00+00:00,Sachsen,915,542,3794,196070,93.0
2021-03-03 00:00:00+00:00,Sachsen,684,534,3744,196754,92.0
2021-03-04 00:00:00+00:00,Sachsen,606,524,3671,197360,90.0
2021-03-05 00:00:00+00:00,Sachsen,589,532,3726,197949,92.0
2021-03-06 00:00:00+00:00,Sachsen,485,542,3797,198434,93.0
2021-03-07 00:00:00+00:00,Sachsen,150,541,3792,198584,93.0
2021-03-08 00:00:00+00:00,Sachsen,497,560,3926,199081,96.0
2021-03-09 00:00:00+00:00,Sachsen,929,562,3940,200010,97.0
2021-03-10 00:00:00+00:00,Sachsen,984,605,4240,200994,104.0
2021-03-11 00:00:00+00:00,Sachsen,808,634,4442,201802,109.0
2021-03-12 00:00:00+00:00,Sachsen,942,685,4795,202744,118.0
2021-03-13 00:00:00+00:00,Sachsen,541,693,4851,203285,119.0
2021-03-14 00:00:00+00:00,Sachsen,209,701,4910,203494,121.0
2021-03-15 00:00:00+00:00,Sachsen,630,720,5043,204124,124.0
2021-03-16 00:00:00+00:00,Sachsen,1258,767,5372,205382,132.0
2021-03-17 00:00:00+00:00,Sachsen,1205,799,5593,206587,137.0
2021-03-18 00:00:00+00:00,Sachsen,1427,887,6212,208014,153.0
2021-03-19 00:00:00+00:00,Sachsen,1205,925,6475,209219,159.0
2021-03-20 00:00:00+00:00,Sachsen,845,968,6779,210064,166.0
2021-03-21 00:00:00+00:00,Sachsen,334,986,6904,210398,170.0
2021-03-22 00:00:00+00:00,Sachsen,863,1019,7137,211261,175.0
2021-03-23 00:00:00+00:00,Sachsen,1727,1086,7606,212988,187.0
2021-03-24 00:00:00+00:00,Sachsen,1597,1142,7998,214585,196.0
2021-03-25 00:00:00+00:00,Sachsen,1601,1167,8172,216186,201.0
2021-03-26 00:00:00+00:00,Sachsen,1441,1201,8408,217627,206.0
2021-03-27 00:00:00+00:00,Sachsen,1028,1227,8591,218655,211.0
2021-03-28 00:00:00+00:00,Sachsen,538,1256,8795,219193,216.0
2021-03-29 00:00:00+00:00,Sachsen,838,1252,8770,220031,215.0
2021-03-30 00:00:00+00:00,Sachsen,1778,1260,8821,221809,217.0
2021-03-31 00:00:00+00:00,Sachsen,1826,1292,9050,223635,222.0
2021-04-01 00:00:00+00:00,Sachsen,1578,1289,9027,225213,222.0
2021-04-02 00:00:00+00:00,Sachsen,863,1207,8449,226076,207.0
2021-04-03 00:00:00+00:00,Sachsen,750,1167,8171,226826,201.0
2021-04-04 00:00:00+00:00,Sachsen,616,1178,8249,227442,203.0
2021-04-05 00:00:00+00:00,Sachsen,445,1122,7856,227887,193.0
2021-04-06 00:00:00+00:00,Sachsen,905,997,6983,228792,171.0
2021-04-07 00:00:00+00:00,Sachsen,2112,1038,7269,230904,179.0
2021-04-08 00:00:00+00:00,Sachsen,2117,1115,7808,233021,192.0
2021-04-09 00:00:00+00:00,Sachsen,1639,1226,8584,234660,211.0
2021-04-10 00:00:00+00:00,Sachsen,1142,1282,8976,235802,220.0
2021-04-11 00:00:00+00:00,Sachsen,623,1283,8983,236425,221.0
2021-04-12 00:00:00+00:00,Sachsen,1093,1375,9631,237518,237.0
2021-04-13 00:00:00+00:00,Sachsen,2357,1583,11083,239875,272.0
2021-04-14 00:00:00+00:00,Sachsen,2146,1588,11117,242021,273.0
2021-04-15 00:00:00+00:00,Sachsen,1578,1511,10578,243599,260.0
2021-04-16 00:00:00+00:00,Sachsen,1389,1475,10328,244988,254.0
2021-04-17 00:00:00+00:00,Sachsen,986,1453,10172,245974,250.0
2021-04-18 00:00:00+00:00,Sachsen,542,1441,10091,246516,248.0
2021-04-19 00:00:00+00:00,Sachsen,833,1404,9831,247349,241.0
2021-04-20 00:00:00+00:00,Sachsen,2258,1390,9732,249607,239.0
2021-04-21 00:00:00+00:00,Sachsen,2041,1375,9627,251648,236.0
2021-04-22 00:00:00+00:00,Sachsen,1647,1385,9696,253295,238.0
2021-04-23 00:00:00+00:00,Sachsen,1631,1419,9938,254926,244.0
2021-04-24 00:00:00+00:00,Sachsen,1080,1433,10032,256006,246.0
2021-04-25 00:00:00+00:00,Sachsen,579,1438,10069,256585,247.0
2021-04-26 00:00:00+00:00,Sachsen,1006,1463,10242,257591,252.0
2021-04-27 00:00:00+00:00,Sachsen,2269,1464,10253,259860,252.0
2021-04-28 00:00:00+00:00,Sachsen,1754,1423,9966,261614,245.0
2021-04-29 00:00:00+00:00,Sachsen,1393,1387,9712,263007,239.0
2021-04-30 00:00:00+00:00,Sachsen,1437,1359,9518,264444,234.0
2021-05-01 00:00:00+00:00,Sachsen,1043,1354,9481,265487,233.0
2021-05-02 00:00:00+00:00,Sachsen,477,1339,9379,265964,230.0
2021-05-03 00:00:00+00:00,Sachsen,780,1307,9153,266744,225.0
2021-05-04 00:00:00+00:00,Sachsen,1906,1255,8790,268650,216.0
2021-05-05 00:00:00+00:00,Sachsen,1604,1234,8640,270254,212.0
2021-05-06 00:00:00+00:00,Sachsen,1207,1207,8454,271461,208.0
2021-05-07 00:00:00+00:00,Sachsen,1050,1152,8067,272511,198.0
2021-05-08 00:00:00+00:00,Sachsen,845,1124,7869,273356,193.0
2021-05-09 00:00:00+00:00,Sachsen,357,1107,7749,273713,190.0
2021-05-10 00:00:00+00:00,Sachsen,574,1077,7543,274287,185.0
2021-05-11 00:00:00+00:00,Sachsen,1444,1011,7081,275731,174.0
2021-05-12 00:00:00+00:00,Sachsen,1148,946,6625,276879,163.0
2021-05-13 00:00:00+00:00,Sachsen,585,857,6003,277464,147.0
2021-05-14 00:00:00+00:00,Sachsen,422,767,5375,277886,132.0
2021-05-15 00:00:00+00:00,Sachsen,519,721,5049,278405,124.0
2021-05-16 00:00:00+00:00,Sachsen,225,702,4917,278630,121.0
2021-05-17 00:00:00+00:00,Sachsen,473,688,4816,279103,118.0
2021-05-18 00:00:00+00:00,Sachsen,1051,631,4423,280154,109.0
2021-05-19 00:00:00+00:00,Sachsen,722,571,3997,280876,98.0
2021-05-20 00:00:00+00:00,Sachsen,468,554,3880,281344,95.0
2021-05-21 00:00:00+00:00,Sachsen,346,543,3804,281690,93.0
2021-05-22 00:00:00+00:00,Sachsen,327,516,3612,282017,89.0
2021-05-23 00:00:00+00:00,Sachsen,58,492,3445,282075,85.0
2021-05-24 00:00:00+00:00,Sachsen,32,429,3004,282107,74.0
2021-05-25 00:00:00+00:00,Sachsen,353,329,2306,282460,57.0
2021-05-26 00:00:00+00:00,Sachsen,506,298,2090,282966,51.0
2021-05-27 00:00:00+00:00,Sachsen,419,291,2041,283385,50.0
2021-05-28 00:00:00+00:00,Sachsen,279,282,1974,283664,48.0
2021-05-29 00:00:00+00:00,Sachsen,183,261,1830,283847,45.0
2021-05-30 00:00:00+00:00,Sachsen,37,258,1809,283884,44.0
2021-05-31 00:00:00+00:00,Sachsen,167,277,1944,284051,48.0
2021-06-01 00:00:00+00:00,Sachsen,286,268,1877,284337,46.0
2021-06-02 00:00:00+00:00,Sachsen,232,229,1603,284569,39.0
2021-06-03 00:00:00+00:00,Sachsen,136,188,1320,284705,32.0
2021-06-04 00:00:00+00:00,Sachsen,118,165,1159,284823,28.0
2021-06-05 00:00:00+00:00,Sachsen,118,156,1094,284941,27.0
2021-06-06 00:00:00+00:00,Sachsen,20,153,1077,284961,26.0
2021-06-07 00:00:00+00:00,Sachsen,64,139,974,285025,24.0
2021-06-08 00:00:00+00:00,Sachsen,162,121,850,285187,21.0
2021-06-09 00:00:00+00:00,Sachsen,95,101,713,285282,18.0
2021-06-10 00:00:00+00:00,Sachsen,83,94,660,285365,16.0
2021-06-11 00:00:00+00:00,Sachsen,62,86,604,285427,15.0
2021-06-12 00:00:00+00:00,Sachsen,27,73,513,285454,13.0
2021-06-13 00:00:00+00:00,Sachsen,11,72,504,285465,12.0
2021-06-14 00:00:00+00:00,Sachsen,31,67,471,285496,12.0
2021-06-15 00:00:00+00:00,Sachsen,71,54,380,285567,9.0
2021-06-16 00:00:00+00:00,Sachsen,34,45,319,285601,8.0
2021-06-17 00:00:00+00:00,Sachsen,38,39,274,285639,7.0
2021-06-18 00:00:00+00:00,Sachsen,27,34,239,285666,6.0
2021-06-19 00:00:00+00:00,Sachsen,20,33,232,285686,6.0
2021-06-20 00:00:00+00:00,Sachsen,4,32,225,285690,6.0
2021-06-21 00:00:00+00:00,Sachsen,27,31,221,285717,5.0
2021-06-22 00:00:00+00:00,Sachsen,41,27,191,285758,5.0
2021-06-23 00:00:00+00:00,Sachsen,16,24,173,285774,4.0
2021-06-24 00:00:00+00:00,Sachsen,24,22,159,285798,4.0
2021-06-25 00:00:00+00:00,Sachsen,19,21,151,285817,4.0
2021-06-26 00:00:00+00:00,Sachsen,11,20,142,285828,3.0
2021-06-27 00:00:00+00:00,Sachsen,9,21,147,285837,4.0
2021-06-28 00:00:00+00:00,Sachsen,27,21,147,285864,4.0
2021-06-29 00:00:00+00:00,Sachsen,22,18,128,285886,3.0
2021-06-30 00:00:00+00:00,Sachsen,9,17,121,285895,3.0
2021-07-01 00:00:00+00:00,Sachsen,22,17,119,285917,3.0
2021-07-02 00:00:00+00:00,Sachsen,5,15,105,285922,3.0
2021-07-03 00:00:00+00:00,Sachsen,3,13,97,285925,2.0
2021-07-04 00:00:00+00:00,Sachsen,2,12,90,285927,2.0
2021-07-05 00:00:00+00:00,Sachsen,9,10,72,285936,2.0
2021-07-06 00:00:00+00:00,Sachsen,10,8,60,285946,1.0
2020-03-02 00:00:00+00:00,Thüringen,1,0,0,1,0.0
2020-03-07 00:00:00+00:00,Thüringen,1,0,0,2,0.0
2020-03-10 00:00:00+00:00,Thüringen,9,0,0,11,0.0
2020-03-11 00:00:00+00:00,Thüringen,1,0,0,12,0.0
2020-03-12 00:00:00+00:00,Thüringen,11,0,0,23,0.0
2020-03-13 00:00:00+00:00,Thüringen,10,0,0,33,0.0
2020-03-14 00:00:00+00:00,Thüringen,18,7,51,51,2.0
2020-03-15 00:00:00+00:00,Thüringen,1,7,51,52,2.0
2020-03-16 00:00:00+00:00,Thüringen,18,9,68,70,3.0
2020-03-17 00:00:00+00:00,Thüringen,31,12,90,101,4.0
2020-03-18 00:00:00+00:00,Thüringen,37,18,126,138,6.0
2020-03-19 00:00:00+00:00,Thüringen,54,24,169,192,8.0
2020-03-20 00:00:00+00:00,Thüringen,77,33,236,269,11.0
2020-03-21 00:00:00+00:00,Thüringen,37,36,255,306,12.0
2020-03-22 00:00:00+00:00,Thüringen,27,40,281,333,13.0
2020-03-23 00:00:00+00:00,Thüringen,52,45,315,385,15.0
2020-03-24 00:00:00+00:00,Thüringen,72,50,356,457,17.0
2020-03-25 00:00:00+00:00,Thüringen,79,56,398,536,19.0
2020-03-26 00:00:00+00:00,Thüringen,74,59,418,610,20.0
2020-03-27 00:00:00+00:00,Thüringen,73,59,414,683,19.0
2020-03-28 00:00:00+00:00,Thüringen,68,63,445,751,21.0
2020-03-29 00:00:00+00:00,Thüringen,20,62,438,771,21.0
2020-03-30 00:00:00+00:00,Thüringen,35,60,421,806,20.0
2020-03-31 00:00:00+00:00,Thüringen,79,61,428,885,20.0
2020-04-01 00:00:00+00:00,Thüringen,57,58,406,942,19.0
2020-04-02 00:00:00+00:00,Thüringen,83,59,415,1025,19.0
2020-04-03 00:00:00+00:00,Thüringen,70,58,412,1095,19.0
2020-04-04 00:00:00+00:00,Thüringen,49,56,393,1144,18.0
2020-04-05 00:00:00+00:00,Thüringen,40,59,413,1184,19.0
2020-04-06 00:00:00+00:00,Thüringen,28,58,406,1212,19.0
2020-04-07 00:00:00+00:00,Thüringen,71,56,398,1283,19.0
2020-04-08 00:00:00+00:00,Thüringen,66,58,407,1349,19.0
2020-04-09 00:00:00+00:00,Thüringen,68,56,392,1417,18.0
2020-04-10 00:00:00+00:00,Thüringen,26,49,348,1443,16.0
2020-04-11 00:00:00+00:00,Thüringen,27,46,326,1470,15.0
2020-04-12 00:00:00+00:00,Thüringen,32,45,318,1502,15.0
2020-04-13 00:00:00+00:00,Thüringen,21,44,311,1523,15.0
2020-04-14 00:00:00+00:00,Thüringen,45,40,285,1568,13.0
2020-04-15 00:00:00+00:00,Thüringen,41,37,260,1609,12.0
2020-04-16 00:00:00+00:00,Thüringen,81,39,273,1690,13.0
2020-04-17 00:00:00+00:00,Thüringen,35,40,282,1725,13.0
2020-04-18 00:00:00+00:00,Thüringen,47,43,302,1772,14.0
2020-04-19 00:00:00+00:00,Thüringen,16,40,286,1788,13.0
2020-04-20 00:00:00+00:00,Thüringen,37,43,302,1825,14.0
2020-04-21 00:00:00+00:00,Thüringen,75,47,332,1900,16.0
2020-04-22 00:00:00+00:00,Thüringen,56,49,347,1956,16.0
2020-04-23 00:00:00+00:00,Thüringen,66,47,332,2022,16.0
2020-04-24 00:00:00+00:00,Thüringen,46,49,343,2068,16.0
2020-04-25 00:00:00+00:00,Thüringen,25,45,321,2093,15.0
2020-04-26 00:00:00+00:00,Thüringen,21,46,326,2114,15.0
2020-04-27 00:00:00+00:00,Thüringen,28,45,317,2142,15.0
2020-04-28 00:00:00+00:00,Thüringen,77,45,319,2219,15.0
2020-04-29 00:00:00+00:00,Thüringen,43,43,306,2262,14.0
2020-04-30 00:00:00+00:00,Thüringen,60,42,300,2322,14.0
2020-05-01 00:00:00+00:00,Thüringen,14,38,268,2336,13.0
2020-05-02 00:00:00+00:00,Thüringen,21,37,264,2357,12.0
2020-05-03 00:00:00+00:00,Thüringen,1,34,244,2358,11.0
2020-05-04 00:00:00+00:00,Thüringen,30,35,246,2388,12.0
2020-05-05 00:00:00+00:00,Thüringen,41,30,210,2429,10.0
2020-05-06 00:00:00+00:00,Thüringen,45,30,212,2474,10.0
2020-05-07 00:00:00+00:00,Thüringen,48,28,200,2522,9.0
2020-05-08 00:00:00+00:00,Thüringen,26,30,212,2548,10.0
2020-05-09 00:00:00+00:00,Thüringen,31,31,222,2579,10.0
2020-05-10 00:00:00+00:00,Thüringen,8,32,229,2587,11.0
2020-05-11 00:00:00+00:00,Thüringen,31,32,230,2618,11.0
2020-05-12 00:00:00+00:00,Thüringen,28,31,217,2646,10.0
2020-05-13 00:00:00+00:00,Thüringen,16,26,188,2662,9.0
2020-05-14 00:00:00+00:00,Thüringen,26,23,166,2688,8.0
2020-05-15 00:00:00+00:00,Thüringen,21,23,161,2709,8.0
2020-05-16 00:00:00+00:00,Thüringen,24,22,154,2733,7.0
2020-05-17 00:00:00+00:00,Thüringen,9,22,155,2742,7.0
2020-05-18 00:00:00+00:00,Thüringen,11,19,135,2753,6.0
2020-05-19 00:00:00+00:00,Thüringen,34,20,141,2787,7.0
2020-05-20 00:00:00+00:00,Thüringen,21,20,146,2808,7.0
2020-05-21 00:00:00+00:00,Thüringen,20,20,140,2828,7.0
2020-05-22 00:00:00+00:00,Thüringen,18,19,137,2846,6.0
2020-05-23 00:00:00+00:00,Thüringen,14,18,127,2860,6.0
2020-05-24 00:00:00+00:00,Thüringen,11,18,129,2871,6.0
2020-05-25 00:00:00+00:00,Thüringen,18,19,136,2889,6.0
2020-05-26 00:00:00+00:00,Thüringen,36,19,138,2925,6.0
2020-05-27 00:00:00+00:00,Thüringen,24,20,141,2949,7.0
2020-05-28 00:00:00+00:00,Thüringen,36,22,157,2985,7.0
2020-05-29 00:00:00+00:00,Thüringen,15,22,154,3000,7.0
2020-05-30 00:00:00+00:00,Thüringen,13,21,153,3013,7.0
2020-05-31 00:00:00+00:00,Thüringen,7,21,149,3020,7.0
2020-06-01 00:00:00+00:00,Thüringen,2,19,133,3022,6.0
2020-06-02 00:00:00+00:00,Thüringen,4,14,101,3026,5.0
2020-06-03 00:00:00+00:00,Thüringen,20,13,97,3046,5.0
2020-06-04 00:00:00+00:00,Thüringen,16,11,77,3062,4.0
2020-06-05 00:00:00+00:00,Thüringen,20,11,82,3082,4.0
2020-06-06 00:00:00+00:00,Thüringen,6,10,75,3088,4.0
2020-06-07 00:00:00+00:00,Thüringen,6,10,74,3094,3.0
2020-06-08 00:00:00+00:00,Thüringen,6,11,78,3100,4.0
2020-06-09 00:00:00+00:00,Thüringen,12,12,86,3112,4.0
2020-06-10 00:00:00+00:00,Thüringen,22,12,88,3134,4.0
2020-06-11 00:00:00+00:00,Thüringen,19,13,91,3153,4.0
2020-06-12 00:00:00+00:00,Thüringen,8,11,79,3161,4.0
2020-06-13 00:00:00+00:00,Thüringen,11,12,84,3172,4.0
2020-06-14 00:00:00+00:00,Thüringen,5,11,83,3177,4.0
2020-06-15 00:00:00+00:00,Thüringen,2,11,79,3179,4.0
2020-06-16 00:00:00+00:00,Thüringen,15,11,82,3194,4.0
2020-06-17 00:00:00+00:00,Thüringen,6,9,66,3200,3.0
2020-06-18 00:00:00+00:00,Thüringen,5,7,52,3205,2.0
2020-06-19 00:00:00+00:00,Thüringen,6,7,50,3211,2.0
2020-06-20 00:00:00+00:00,Thüringen,8,6,47,3219,2.0
2020-06-22 00:00:00+00:00,Thüringen,5,6,47,3224,2.0
2020-06-23 00:00:00+00:00,Thüringen,2,6,47,3226,2.0
2020-06-24 00:00:00+00:00,Thüringen,3,5,35,3229,2.0
2020-06-25 00:00:00+00:00,Thüringen,4,4,33,3233,2.0
2020-06-26 00:00:00+00:00,Thüringen,5,4,33,3238,2.0
2020-06-29 00:00:00+00:00,Thüringen,2,4,29,3240,1.0
2020-06-30 00:00:00+00:00,Thüringen,5,3,26,3245,1.0
2020-07-01 00:00:00+00:00,Thüringen,1,3,22,3246,1.0
2020-07-02 00:00:00+00:00,Thüringen,10,4,30,3256,1.0
2020-07-04 00:00:00+00:00,Thüringen,2,4,29,3258,1.0
2020-07-05 00:00:00+00:00,Thüringen,2,3,27,3260,1.0
2020-07-06 00:00:00+00:00,Thüringen,5,3,27,3265,1.0
2020-07-07 00:00:00+00:00,Thüringen,7,4,32,3272,1.0
2020-07-08 00:00:00+00:00,Thüringen,3,4,30,3275,1.0
2020-07-09 00:00:00+00:00,Thüringen,2,4,31,3277,1.0
2020-07-10 00:00:00+00:00,Thüringen,1,3,22,3278,1.0
2020-07-11 00:00:00+00:00,Thüringen,3,3,23,3281,1.0
2020-07-12 00:00:00+00:00,Thüringen,1,3,22,3282,1.0
2020-07-13 00:00:00+00:00,Thüringen,3,2,20,3285,1.0
2020-07-14 00:00:00+00:00,Thüringen,7,2,20,3292,1.0
2020-07-15 00:00:00+00:00,Thüringen,9,3,26,3301,1.0
2020-07-16 00:00:00+00:00,Thüringen,5,4,29,3306,1.0
2020-07-17 00:00:00+00:00,Thüringen,3,4,31,3309,1.0
2020-07-18 00:00:00+00:00,Thüringen,1,4,29,3310,1.0
2020-07-19 00:00:00+00:00,Thüringen,1,4,29,3311,1.0
2020-07-20 00:00:00+00:00,Thüringen,2,4,28,3313,1.0
2020-07-21 00:00:00+00:00,Thüringen,1,3,22,3314,1.0
2020-07-22 00:00:00+00:00,Thüringen,1,2,14,3315,1.0
2020-07-23 00:00:00+00:00,Thüringen,12,3,21,3327,1.0
2020-07-24 00:00:00+00:00,Thüringen,2,2,20,3329,1.0
2020-07-25 00:00:00+00:00,Thüringen,6,3,25,3335,1.0
2020-07-26 00:00:00+00:00,Thüringen,1,3,25,3336,1.0
2020-07-27 00:00:00+00:00,Thüringen,4,3,27,3340,1.0
2020-07-28 00:00:00+00:00,Thüringen,6,4,32,3346,1.0
2020-07-29 00:00:00+00:00,Thüringen,3,4,34,3349,2.0
2020-07-30 00:00:00+00:00,Thüringen,6,4,28,3355,1.0
2020-07-31 00:00:00+00:00,Thüringen,6,4,32,3361,1.0
2020-08-01 00:00:00+00:00,Thüringen,3,4,29,3364,1.0
2020-08-02 00:00:00+00:00,Thüringen,1,4,29,3365,1.0
2020-08-03 00:00:00+00:00,Thüringen,10,5,35,3375,2.0
2020-08-04 00:00:00+00:00,Thüringen,5,4,34,3380,2.0
2020-08-05 00:00:00+00:00,Thüringen,10,5,41,3390,2.0
2020-08-06 00:00:00+00:00,Thüringen,14,7,49,3404,2.0
2020-08-07 00:00:00+00:00,Thüringen,10,7,53,3414,2.0
2020-08-08 00:00:00+00:00,Thüringen,2,7,52,3416,2.0
2020-08-09 00:00:00+00:00,Thüringen,1,7,52,3417,2.0
2020-08-10 00:00:00+00:00,Thüringen,13,7,55,3430,3.0
2020-08-11 00:00:00+00:00,Thüringen,14,9,64,3444,3.0
2020-08-12 00:00:00+00:00,Thüringen,19,10,73,3463,3.0
2020-08-13 00:00:00+00:00,Thüringen,11,10,70,3474,3.0
2020-08-14 00:00:00+00:00,Thüringen,11,10,71,3485,3.0
2020-08-15 00:00:00+00:00,Thüringen,1,10,70,3486,3.0
2020-08-16 00:00:00+00:00,Thüringen,2,10,71,3488,3.0
2020-08-17 00:00:00+00:00,Thüringen,5,9,63,3493,3.0
2020-08-18 00:00:00+00:00,Thüringen,13,8,62,3506,3.0
2020-08-19 00:00:00+00:00,Thüringen,6,7,49,3512,2.0
2020-08-20 00:00:00+00:00,Thüringen,13,7,51,3525,2.0
2020-08-21 00:00:00+00:00,Thüringen,9,7,49,3534,2.0
2020-08-22 00:00:00+00:00,Thüringen,7,7,55,3541,3.0
2020-08-23 00:00:00+00:00,Thüringen,4,8,57,3545,3.0
2020-08-24 00:00:00+00:00,Thüringen,10,8,62,3555,3.0
2020-08-25 00:00:00+00:00,Thüringen,9,8,58,3564,3.0
2020-08-26 00:00:00+00:00,Thüringen,8,8,60,3572,3.0
2020-08-27 00:00:00+00:00,Thüringen,14,8,61,3586,3.0
2020-08-28 00:00:00+00:00,Thüringen,23,10,75,3609,4.0
2020-08-29 00:00:00+00:00,Thüringen,9,11,77,3618,4.0
2020-08-31 00:00:00+00:00,Thüringen,5,11,78,3623,4.0
2020-09-01 00:00:00+00:00,Thüringen,10,11,78,3633,4.0
2020-09-02 00:00:00+00:00,Thüringen,11,11,80,3644,4.0
2020-09-03 00:00:00+00:00,Thüringen,12,12,84,3656,4.0
2020-09-04 00:00:00+00:00,Thüringen,19,12,89,3675,4.0
2020-09-05 00:00:00+00:00,Thüringen,4,10,70,3679,3.0
2020-09-06 00:00:00+00:00,Thüringen,7,9,68,3686,3.0
2020-09-07 00:00:00+00:00,Thüringen,3,9,66,3689,3.0
2020-09-08 00:00:00+00:00,Thüringen,10,9,66,3699,3.0
2020-09-09 00:00:00+00:00,Thüringen,19,10,74,3718,3.0
2020-09-10 00:00:00+00:00,Thüringen,19,11,81,3737,4.0
2020-09-11 00:00:00+00:00,Thüringen,24,12,86,3761,4.0
2020-09-12 00:00:00+00:00,Thüringen,23,15,105,3784,5.0
2020-09-13 00:00:00+00:00,Thüringen,13,15,111,3797,5.0
2020-09-14 00:00:00+00:00,Thüringen,17,17,125,3814,6.0
2020-09-15 00:00:00+00:00,Thüringen,26,20,141,3840,7.0
2020-09-16 00:00:00+00:00,Thüringen,25,21,147,3865,7.0
2020-09-17 00:00:00+00:00,Thüringen,26,22,154,3891,7.0
2020-09-18 00:00:00+00:00,Thüringen,31,23,161,3922,8.0
2020-09-19 00:00:00+00:00,Thüringen,7,20,145,3929,7.0
2020-09-20 00:00:00+00:00,Thüringen,6,19,138,3935,6.0
2020-09-21 00:00:00+00:00,Thüringen,26,21,147,3961,7.0
2020-09-22 00:00:00+00:00,Thüringen,17,19,138,3978,6.0
2020-09-23 00:00:00+00:00,Thüringen,21,19,134,3999,6.0
2020-09-24 00:00:00+00:00,Thüringen,21,18,129,4020,6.0
2020-09-25 00:00:00+00:00,Thüringen,18,16,116,4038,5.0
2020-09-26 00:00:00+00:00,Thüringen,7,16,116,4045,5.0
2020-09-27 00:00:00+00:00,Thüringen,3,16,113,4048,5.0
2020-09-28 00:00:00+00:00,Thüringen,8,13,95,4056,4.0
2020-09-29 00:00:00+00:00,Thüringen,15,13,93,4071,4.0
2020-09-30 00:00:00+00:00,Thüringen,30,14,102,4101,5.0
2020-10-01 00:00:00+00:00,Thüringen,29,15,110,4130,5.0
2020-10-02 00:00:00+00:00,Thüringen,30,17,122,4160,6.0
2020-10-03 00:00:00+00:00,Thüringen,35,21,150,4195,7.0
2020-10-04 00:00:00+00:00,Thüringen,7,22,154,4202,7.0
2020-10-05 00:00:00+00:00,Thüringen,10,22,156,4212,7.0
2020-10-06 00:00:00+00:00,Thüringen,18,22,159,4230,7.0
2020-10-07 00:00:00+00:00,Thüringen,44,24,173,4274,8.0
2020-10-08 00:00:00+00:00,Thüringen,48,27,192,4322,9.0
2020-10-09 00:00:00+00:00,Thüringen,60,31,222,4382,10.0
2020-10-10 00:00:00+00:00,Thüringen,53,34,240,4435,11.0
2020-10-11 00:00:00+00:00,Thüringen,8,34,241,4443,11.0
2020-10-12 00:00:00+00:00,Thüringen,58,41,289,4501,14.0
2020-10-13 00:00:00+00:00,Thüringen,59,47,330,4560,15.0
2020-10-14 00:00:00+00:00,Thüringen,78,52,364,4638,17.0
2020-10-15 00:00:00+00:00,Thüringen,74,55,390,4712,18.0
2020-10-16 00:00:00+00:00,Thüringen,124,64,454,4836,21.0
2020-10-17 00:00:00+00:00,Thüringen,70,67,471,4906,22.0
2020-10-18 00:00:00+00:00,Thüringen,32,70,495,4938,23.0
2020-10-19 00:00:00+00:00,Thüringen,63,71,500,5001,23.0
2020-10-20 00:00:00+00:00,Thüringen,117,79,558,5118,26.0
2020-10-21 00:00:00+00:00,Thüringen,164,92,644,5282,30.0
2020-10-22 00:00:00+00:00,Thüringen,164,104,734,5446,34.0
2020-10-23 00:00:00+00:00,Thüringen,198,115,808,5644,38.0
2020-10-24 00:00:00+00:00,Thüringen,205,134,943,5849,44.0
2020-10-25 00:00:00+00:00,Thüringen,69,140,980,5918,46.0
2020-10-26 00:00:00+00:00,Thüringen,96,144,1013,6014,47.0
2020-10-27 00:00:00+00:00,Thüringen,254,164,1150,6268,54.0
2020-10-28 00:00:00+00:00,Thüringen,227,173,1213,6495,57.0
2020-10-29 00:00:00+00:00,Thüringen,229,182,1278,6724,60.0
2020-10-30 00:00:00+00:00,Thüringen,334,202,1414,7058,66.0
2020-10-31 00:00:00+00:00,Thüringen,168,196,1377,7226,65.0
2020-11-01 00:00:00+00:00,Thüringen,62,195,1370,7288,64.0
2020-11-02 00:00:00+00:00,Thüringen,204,211,1478,7492,69.0
2020-11-03 00:00:00+00:00,Thüringen,282,215,1506,7774,71.0
2020-11-04 00:00:00+00:00,Thüringen,332,230,1611,8106,76.0
2020-11-05 00:00:00+00:00,Thüringen,304,240,1686,8410,79.0
2020-11-06 00:00:00+00:00,Thüringen,301,236,1653,8711,77.0
2020-11-07 00:00:00+00:00,Thüringen,234,245,1719,8945,81.0
2020-11-08 00:00:00+00:00,Thüringen,98,250,1755,9043,82.0
2020-11-09 00:00:00+00:00,Thüringen,207,251,1758,9250,82.0
2020-11-10 00:00:00+00:00,Thüringen,300,253,1776,9550,83.0
2020-11-11 00:00:00+00:00,Thüringen,354,256,1798,9904,84.0
2020-11-12 00:00:00+00:00,Thüringen,404,271,1898,10308,89.0
2020-11-13 00:00:00+00:00,Thüringen,384,283,1981,10692,93.0
2020-11-14 00:00:00+00:00,Thüringen,249,285,1996,10941,94.0
2020-11-15 00:00:00+00:00,Thüringen,121,288,2019,11062,95.0
2020-11-16 00:00:00+00:00,Thüringen,239,293,2051,11301,96.0
2020-11-17 00:00:00+00:00,Thüringen,432,311,2183,11733,102.0
2020-11-18 00:00:00+00:00,Thüringen,418,321,2247,12151,105.0
2020-11-19 00:00:00+00:00,Thüringen,472,330,2315,12623,109.0
2020-11-20 00:00:00+00:00,Thüringen,646,368,2577,13269,121.0
2020-11-21 00:00:00+00:00,Thüringen,477,400,2805,13746,131.0
2020-11-22 00:00:00+00:00,Thüringen,193,411,2877,13939,135.0
2020-11-23 00:00:00+00:00,Thüringen,375,430,3013,14314,141.0
2020-11-24 00:00:00+00:00,Thüringen,582,451,3163,14896,148.0
2020-11-25 00:00:00+00:00,Thüringen,547,470,3292,15443,154.0
2020-11-26 00:00:00+00:00,Thüringen,573,484,3393,16016,159.0
2020-11-27 00:00:00+00:00,Thüringen,510,465,3257,16526,153.0
2020-11-28 00:00:00+00:00,Thüringen,371,450,3151,16897,148.0
2020-11-29 00:00:00+00:00,Thüringen,248,458,3206,17145,150.0
2020-11-30 00:00:00+00:00,Thüringen,350,454,3181,17495,149.0
2020-12-01 00:00:00+00:00,Thüringen,504,443,3103,17999,145.0
2020-12-02 00:00:00+00:00,Thüringen,726,468,3282,18725,154.0
2020-12-03 00:00:00+00:00,Thüringen,886,513,3595,19611,169.0
2020-12-04 00:00:00+00:00,Thüringen,694,539,3779,20305,177.0
2020-12-05 00:00:00+00:00,Thüringen,412,545,3820,20717,179.0
2020-12-06 00:00:00+00:00,Thüringen,393,566,3965,21110,186.0
2020-12-07 00:00:00+00:00,Thüringen,436,578,4051,21546,190.0
2020-12-08 00:00:00+00:00,Thüringen,717,609,4264,22263,200.0
2020-12-09 00:00:00+00:00,Thüringen,863,628,4401,23126,206.0
2020-12-10 00:00:00+00:00,Thüringen,1063,654,4578,24189,215.0
2020-12-11 00:00:00+00:00,Thüringen,1030,702,4914,25219,230.0
2020-12-12 00:00:00+00:00,Thüringen,848,764,5350,26067,251.0
2020-12-13 00:00:00+00:00,Thüringen,363,760,5320,26430,249.0
2020-12-14 00:00:00+00:00,Thüringen,738,803,5622,27168,264.0
2020-12-15 00:00:00+00:00,Thüringen,884,827,5789,28052,271.0
2020-12-16 00:00:00+00:00,Thüringen,1173,871,6099,29225,286.0
2020-12-17 00:00:00+00:00,Thüringen,1230,895,6266,30455,294.0
2020-12-18 00:00:00+00:00,Thüringen,1240,925,6476,31695,304.0
2020-12-19 00:00:00+00:00,Thüringen,860,926,6488,32555,304.0
2020-12-20 00:00:00+00:00,Thüringen,394,931,6519,32949,306.0
2020-12-21 00:00:00+00:00,Thüringen,862,949,6643,33811,311.0
2020-12-22 00:00:00+00:00,Thüringen,1384,1020,7143,35195,335.0
2020-12-23 00:00:00+00:00,Thüringen,1555,1075,7525,36750,353.0
2020-12-24 00:00:00+00:00,Thüringen,996,1041,7291,37746,342.0
2020-12-25 00:00:00+00:00,Thüringen,837,984,6888,38583,323.0
2020-12-26 00:00:00+00:00,Thüringen,394,917,6422,38977,301.0
2020-12-27 00:00:00+00:00,Thüringen,265,899,6293,39242,295.0
2020-12-28 00:00:00+00:00,Thüringen,621,864,6052,39863,284.0
2020-12-29 00:00:00+00:00,Thüringen,1126,827,5794,40989,272.0
2020-12-30 00:00:00+00:00,Thüringen,1571,830,5810,42560,272.0
2020-12-31 00:00:00+00:00,Thüringen,934,821,5748,43494,269.0
2021-01-01 00:00:00+00:00,Thüringen,560,781,5471,44054,256.0
2021-01-02 00:00:00+00:00,Thüringen,408,783,5485,44462,257.0
2021-01-03 00:00:00+00:00,Thüringen,283,786,5503,44745,258.0
2021-01-04 00:00:00+00:00,Thüringen,533,773,5415,45278,254.0
2021-01-05 00:00:00+00:00,Thüringen,1274,794,5563,46552,261.0
2021-01-06 00:00:00+00:00,Thüringen,1386,768,5378,47938,252.0
2021-01-07 00:00:00+00:00,Thüringen,1459,843,5903,49397,277.0
2021-01-08 00:00:00+00:00,Thüringen,1328,953,6671,50725,313.0
2021-01-09 00:00:00+00:00,Thüringen,586,978,6849,51311,321.0
2021-01-10 00:00:00+00:00,Thüringen,324,984,6890,51635,323.0
2021-01-11 00:00:00+00:00,Thüringen,821,1025,7178,52456,336.0
2021-01-12 00:00:00+00:00,Thüringen,1167,1010,7071,53623,331.0
2021-01-13 00:00:00+00:00,Thüringen,1210,985,6895,54833,323.0
2021-01-14 00:00:00+00:00,Thüringen,983,917,6419,55816,301.0
2021-01-15 00:00:00+00:00,Thüringen,916,858,6007,56732,282.0
2021-01-16 00:00:00+00:00,Thüringen,648,867,6069,57380,284.0
2021-01-17 00:00:00+00:00,Thüringen,268,859,6013,57648,282.0
2021-01-18 00:00:00+00:00,Thüringen,475,809,5667,58123,266.0
2021-01-19 00:00:00+00:00,Thüringen,893,770,5393,59016,253.0
2021-01-20 00:00:00+00:00,Thüringen,907,727,5090,59923,239.0
2021-01-21 00:00:00+00:00,Thüringen,763,695,4870,60686,228.0
2021-01-22 00:00:00+00:00,Thüringen,670,660,4624,61356,217.0
2021-01-23 00:00:00+00:00,Thüringen,488,637,4464,61844,209.0
2021-01-24 00:00:00+00:00,Thüringen,226,631,4422,62070,207.0
2021-01-25 00:00:00+00:00,Thüringen,319,609,4266,62389,200.0
2021-01-26 00:00:00+00:00,Thüringen,705,582,4078,63094,191.0
2021-01-27 00:00:00+00:00,Thüringen,707,554,3878,63801,182.0
2021-01-28 00:00:00+00:00,Thüringen,678,541,3793,64479,178.0
2021-01-29 00:00:00+00:00,Thüringen,519,520,3642,64998,171.0
2021-01-30 00:00:00+00:00,Thüringen,380,504,3534,65378,166.0
2021-01-31 00:00:00+00:00,Thüringen,156,494,3464,65534,162.0
2021-02-01 00:00:00+00:00,Thüringen,290,490,3435,65824,161.0
2021-02-02 00:00:00+00:00,Thüringen,622,478,3352,66446,157.0
2021-02-03 00:00:00+00:00,Thüringen,681,475,3326,67127,156.0
2021-02-04 00:00:00+00:00,Thüringen,569,459,3217,67696,151.0
2021-02-05 00:00:00+00:00,Thüringen,484,454,3182,68180,149.0
2021-02-06 00:00:00+00:00,Thüringen,312,444,3114,68492,146.0
2021-02-07 00:00:00+00:00,Thüringen,101,437,3059,68593,143.0
2021-02-08 00:00:00+00:00,Thüringen,240,429,3009,68833,141.0
2021-02-09 00:00:00+00:00,Thüringen,269,379,2656,69102,124.0
2021-02-10 00:00:00+00:00,Thüringen,334,329,2309,69436,108.0
2021-02-11 00:00:00+00:00,Thüringen,538,325,2278,69974,107.0
2021-02-12 00:00:00+00:00,Thüringen,427,317,2221,70401,104.0
2021-02-13 00:00:00+00:00,Thüringen,278,312,2187,70679,103.0
2021-02-14 00:00:00+00:00,Thüringen,150,319,2236,70829,105.0
2021-02-15 00:00:00+00:00,Thüringen,262,322,2258,71091,106.0
2021-02-16 00:00:00+00:00,Thüringen,512,357,2501,71603,117.0
2021-02-17 00:00:00+00:00,Thüringen,560,389,2727,72163,128.0
2021-02-18 00:00:00+00:00,Thüringen,498,383,2687,72661,126.0
2021-02-19 00:00:00+00:00,Thüringen,421,383,2681,73082,126.0
2021-02-20 00:00:00+00:00,Thüringen,330,390,2733,73412,128.0
2021-02-21 00:00:00+00:00,Thüringen,160,391,2743,73572,129.0
2021-02-22 00:00:00+00:00,Thüringen,216,385,2697,73788,126.0
2021-02-23 00:00:00+00:00,Thüringen,495,382,2680,74283,126.0
2021-02-24 00:00:00+00:00,Thüringen,622,391,2742,74905,129.0
2021-02-25 00:00:00+00:00,Thüringen,495,391,2739,75400,128.0
2021-02-26 00:00:00+00:00,Thüringen,471,398,2789,75871,131.0
2021-02-27 00:00:00+00:00,Thüringen,337,399,2796,76208,131.0
2021-02-28 00:00:00+00:00,Thüringen,127,394,2763,76335,130.0
2021-03-01 00:00:00+00:00,Thüringen,226,396,2773,76561,130.0
2021-03-02 00:00:00+00:00,Thüringen,501,397,2779,77062,130.0
2021-03-03 00:00:00+00:00,Thüringen,684,405,2841,77746,133.0
2021-03-04 00:00:00+00:00,Thüringen,513,408,2859,78259,134.0
2021-03-05 00:00:00+00:00,Thüringen,460,406,2848,78719,133.0
2021-03-06 00:00:00+00:00,Thüringen,417,418,2928,79136,137.0
2021-03-07 00:00:00+00:00,Thüringen,158,422,2959,79294,139.0
2021-03-08 00:00:00+00:00,Thüringen,251,426,2984,79545,140.0
2021-03-09 00:00:00+00:00,Thüringen,555,434,3038,80100,142.0
2021-03-10 00:00:00+00:00,Thüringen,756,444,3110,80856,146.0
2021-03-11 00:00:00+00:00,Thüringen,700,471,3297,81556,155.0
2021-03-12 00:00:00+00:00,Thüringen,568,486,3405,82124,160.0
2021-03-13 00:00:00+00:00,Thüringen,557,506,3545,82681,166.0
2021-03-14 00:00:00+00:00,Thüringen,263,521,3650,82944,171.0
2021-03-15 00:00:00+00:00,Thüringen,338,533,3737,83282,175.0
2021-03-16 00:00:00+00:00,Thüringen,791,567,3973,84073,186.0
2021-03-17 00:00:00+00:00,Thüringen,814,575,4031,84887,189.0
2021-03-18 00:00:00+00:00,Thüringen,840,595,4171,85727,196.0
2021-03-19 00:00:00+00:00,Thüringen,847,635,4450,86574,209.0
2021-03-20 00:00:00+00:00,Thüringen,625,645,4518,87199,212.0
2021-03-21 00:00:00+00:00,Thüringen,286,648,4541,87485,213.0
2021-03-22 00:00:00+00:00,Thüringen,400,657,4603,87885,216.0
2021-03-23 00:00:00+00:00,Thüringen,860,667,4672,88745,219.0
2021-03-24 00:00:00+00:00,Thüringen,1035,699,4893,89780,229.0
2021-03-25 00:00:00+00:00,Thüringen,883,705,4936,90663,231.0
2021-03-26 00:00:00+00:00,Thüringen,941,718,5030,91604,236.0
2021-03-27 00:00:00+00:00,Thüringen,718,731,5123,92322,240.0
2021-03-28 00:00:00+00:00,Thüringen,361,742,5198,92683,244.0
2021-03-29 00:00:00+00:00,Thüringen,547,763,5345,93230,251.0
2021-03-30 00:00:00+00:00,Thüringen,923,772,5408,94153,253.0
2021-03-31 00:00:00+00:00,Thüringen,1184,793,5557,95337,260.0
2021-04-01 00:00:00+00:00,Thüringen,947,803,5621,96284,263.0
2021-04-02 00:00:00+00:00,Thüringen,675,765,5355,96959,251.0
2021-04-03 00:00:00+00:00,Thüringen,477,730,5114,97436,240.0
2021-04-04 00:00:00+00:00,Thüringen,228,711,4981,97664,233.0
2021-04-05 00:00:00+00:00,Thüringen,253,669,4687,97917,220.0
2021-04-06 00:00:00+00:00,Thüringen,482,606,4246,98399,199.0
2021-04-07 00:00:00+00:00,Thüringen,1095,593,4157,99494,195.0
2021-04-08 00:00:00+00:00,Thüringen,1122,618,4332,100616,203.0
2021-04-09 00:00:00+00:00,Thüringen,1003,665,4660,101619,218.0
2021-04-10 00:00:00+00:00,Thüringen,681,694,4864,102300,228.0
2021-04-11 00:00:00+00:00,Thüringen,299,705,4935,102599,231.0
2021-04-12 00:00:00+00:00,Thüringen,461,734,5143,103060,241.0
2021-04-13 00:00:00+00:00,Thüringen,1016,811,5677,104076,266.0
2021-04-14 00:00:00+00:00,Thüringen,1246,832,5828,105322,273.0
2021-04-15 00:00:00+00:00,Thüringen,1003,815,5709,106325,268.0
2021-04-16 00:00:00+00:00,Thüringen,837,791,5543,107162,260.0
2021-04-17 00:00:00+00:00,Thüringen,537,771,5399,107699,253.0
2021-04-18 00:00:00+00:00,Thüringen,284,769,5384,107983,252.0
2021-04-19 00:00:00+00:00,Thüringen,475,771,5398,108458,253.0
2021-04-20 00:00:00+00:00,Thüringen,985,766,5367,109443,252.0
2021-04-21 00:00:00+00:00,Thüringen,1006,732,5127,110449,240.0
2021-04-22 00:00:00+00:00,Thüringen,874,714,4998,111323,234.0
2021-04-23 00:00:00+00:00,Thüringen,767,704,4928,112090,231.0
2021-04-24 00:00:00+00:00,Thüringen,645,719,5036,112735,236.0
2021-04-25 00:00:00+00:00,Thüringen,289,720,5041,113024,236.0
2021-04-26 00:00:00+00:00,Thüringen,418,712,4984,113442,234.0
2021-04-27 00:00:00+00:00,Thüringen,915,702,4914,114357,230.0
2021-04-28 00:00:00+00:00,Thüringen,874,683,4782,115231,224.0
2021-04-29 00:00:00+00:00,Thüringen,841,678,4749,116072,223.0
2021-04-30 00:00:00+00:00,Thüringen,856,691,4838,116928,227.0
2021-05-01 00:00:00+00:00,Thüringen,522,673,4715,117450,221.0
2021-05-02 00:00:00+00:00,Thüringen,290,673,4716,117740,221.0
2021-05-03 00:00:00+00:00,Thüringen,385,669,4683,118125,220.0
2021-05-04 00:00:00+00:00,Thüringen,808,653,4576,118933,214.0
2021-05-05 00:00:00+00:00,Thüringen,786,641,4488,119719,210.0
2021-05-06 00:00:00+00:00,Thüringen,669,616,4316,120388,202.0
2021-05-07 00:00:00+00:00,Thüringen,611,581,4071,120999,191.0
2021-05-08 00:00:00+00:00,Thüringen,459,572,4008,121458,188.0
2021-05-09 00:00:00+00:00,Thüringen,218,562,3936,121676,184.0
2021-05-10 00:00:00+00:00,Thüringen,329,554,3880,122005,182.0
2021-05-11 00:00:00+00:00,Thüringen,632,529,3704,122637,174.0
2021-05-12 00:00:00+00:00,Thüringen,675,513,3593,123312,168.0
2021-05-13 00:00:00+00:00,Thüringen,323,463,3247,123635,152.0
2021-05-14 00:00:00+00:00,Thüringen,307,420,2943,123942,138.0
2021-05-15 00:00:00+00:00,Thüringen,287,395,2771,124229,130.0
2021-05-16 00:00:00+00:00,Thüringen,154,386,2707,124383,127.0
2021-05-17 00:00:00+00:00,Thüringen,262,377,2640,124645,124.0
2021-05-18 00:00:00+00:00,Thüringen,521,361,2529,125166,119.0
2021-05-19 00:00:00+00:00,Thüringen,493,335,2347,125659,110.0
2021-05-20 00:00:00+00:00,Thüringen,295,331,2319,125954,109.0
2021-05-21 00:00:00+00:00,Thüringen,280,327,2292,126234,107.0
2021-05-22 00:00:00+00:00,Thüringen,193,314,2198,126427,103.0
2021-05-23 00:00:00+00:00,Thüringen,63,301,2107,126490,99.0
2021-05-24 00:00:00+00:00,Thüringen,54,271,1899,126544,89.0
2021-05-25 00:00:00+00:00,Thüringen,178,222,1556,126722,73.0
2021-05-26 00:00:00+00:00,Thüringen,272,190,1335,126994,63.0
2021-05-27 00:00:00+00:00,Thüringen,203,177,1243,127197,58.0
2021-05-28 00:00:00+00:00,Thüringen,159,160,1122,127356,53.0
2021-05-29 00:00:00+00:00,Thüringen,109,148,1038,127465,49.0
2021-05-30 00:00:00+00:00,Thüringen,32,143,1007,127497,47.0
2021-05-31 00:00:00+00:00,Thüringen,90,149,1043,127587,49.0
2021-06-01 00:00:00+00:00,Thüringen,150,145,1015,127737,48.0
2021-06-02 00:00:00+00:00,Thüringen,100,120,843,127837,40.0
2021-06-03 00:00:00+00:00,Thüringen,87,103,727,127924,34.0
2021-06-04 00:00:00+00:00,Thüringen,104,96,672,128028,31.0
2021-06-05 00:00:00+00:00,Thüringen,83,92,646,128111,30.0
2021-06-06 00:00:00+00:00,Thüringen,14,89,628,128125,29.0
2021-06-07 00:00:00+00:00,Thüringen,56,84,594,128181,28.0
2021-06-08 00:00:00+00:00,Thüringen,75,74,519,128256,24.0
2021-06-09 00:00:00+00:00,Thüringen,68,69,487,128324,23.0
2021-06-10 00:00:00+00:00,Thüringen,50,64,450,128374,21.0
2021-06-11 00:00:00+00:00,Thüringen,58,57,404,128432,19.0
2021-06-12 00:00:00+00:00,Thüringen,30,50,351,128462,16.0
2021-06-13 00:00:00+00:00,Thüringen,3,48,340,128465,16.0
2021-06-14 00:00:00+00:00,Thüringen,20,43,304,128485,14.0
2021-06-15 00:00:00+00:00,Thüringen,43,38,272,128528,13.0
2021-06-16 00:00:00+00:00,Thüringen,40,34,244,128568,11.0
2021-06-17 00:00:00+00:00,Thüringen,15,29,209,128583,10.0
2021-06-18 00:00:00+00:00,Thüringen,25,25,176,128608,8.0
2021-06-19 00:00:00+00:00,Thüringen,14,22,160,128622,7.0
2021-06-20 00:00:00+00:00,Thüringen,4,23,161,128626,8.0
2021-06-21 00:00:00+00:00,Thüringen,20,23,161,128646,8.0
2021-06-22 00:00:00+00:00,Thüringen,19,19,137,128665,6.0
2021-06-23 00:00:00+00:00,Thüringen,15,16,112,128680,5.0
2021-06-24 00:00:00+00:00,Thüringen,13,15,110,128693,5.0
2021-06-25 00:00:00+00:00,Thüringen,9,13,94,128702,4.0
2021-06-26 00:00:00+00:00,Thüringen,3,11,83,128705,4.0
2021-06-27 00:00:00+00:00,Thüringen,1,11,80,128706,4.0
2021-06-28 00:00:00+00:00,Thüringen,11,10,71,128717,3.0
2021-06-29 00:00:00+00:00,Thüringen,23,10,75,128740,4.0
2021-06-30 00:00:00+00:00,Thüringen,18,11,78,128758,4.0
2021-07-01 00:00:00+00:00,Thüringen,18,11,83,128776,4.0
2021-07-02 00:00:00+00:00,Thüringen,8,11,82,128784,4.0
2021-07-03 00:00:00+00:00,Thüringen,3,11,82,128787,4.0
2021-07-04 00:00:00+00:00,Thüringen,2,11,83,128789,4.0
2021-07-05 00:00:00+00:00,Thüringen,7,11,79,128796,4.0
2021-07-06 00:00:00+00:00,Thüringen,12,9,68,128808,3.0
2020-03-03 00:00:00+00:00,Mecklenburg-Vorpommern,2,0,0,2,0.0
2020-03-04 00:00:00+00:00,Mecklenburg-Vorpommern,2,0,0,4,0.0
2020-03-05 00:00:00+00:00,Mecklenburg-Vorpommern,1,0,0,5,0.0
2020-03-08 00:00:00+00:00,Mecklenburg-Vorpommern,2,0,0,7,0.0
2020-03-09 00:00:00+00:00,Mecklenburg-Vorpommern,4,0,0,11,0.0
2020-03-10 00:00:00+00:00,Mecklenburg-Vorpommern,1,0,0,12,0.0
2020-03-11 00:00:00+00:00,Mecklenburg-Vorpommern,8,2,20,20,1.0
2020-03-12 00:00:00+00:00,Mecklenburg-Vorpommern,9,3,27,29,2.0
2020-03-13 00:00:00+00:00,Mecklenburg-Vorpommern,9,4,34,38,2.0
2020-03-14 00:00:00+00:00,Mecklenburg-Vorpommern,1,4,34,39,2.0
2020-03-15 00:00:00+00:00,Mecklenburg-Vorpommern,1,4,33,40,2.0
2020-03-16 00:00:00+00:00,Mecklenburg-Vorpommern,14,6,43,54,3.0
2020-03-17 00:00:00+00:00,Mecklenburg-Vorpommern,31,10,73,85,5.0
2020-03-18 00:00:00+00:00,Mecklenburg-Vorpommern,44,15,109,129,7.0
2020-03-19 00:00:00+00:00,Mecklenburg-Vorpommern,34,19,134,163,8.0
2020-03-20 00:00:00+00:00,Mecklenburg-Vorpommern,16,20,141,179,9.0
2020-03-21 00:00:00+00:00,Mecklenburg-Vorpommern,11,21,151,190,9.0
2020-03-22 00:00:00+00:00,Mecklenburg-Vorpommern,1,21,151,191,9.0
2020-03-23 00:00:00+00:00,Mecklenburg-Vorpommern,13,21,150,204,9.0
2020-03-24 00:00:00+00:00,Mecklenburg-Vorpommern,37,22,156,241,10.0
2020-03-25 00:00:00+00:00,Mecklenburg-Vorpommern,24,19,136,265,8.0
2020-03-26 00:00:00+00:00,Mecklenburg-Vorpommern,24,18,126,289,8.0
2020-03-27 00:00:00+00:00,Mecklenburg-Vorpommern,42,21,152,331,9.0
2020-03-28 00:00:00+00:00,Mecklenburg-Vorpommern,21,23,162,352,10.0
2020-03-29 00:00:00+00:00,Mecklenburg-Vorpommern,11,24,172,363,11.0
2020-03-30 00:00:00+00:00,Mecklenburg-Vorpommern,13,24,172,376,11.0
2020-03-31 00:00:00+00:00,Mecklenburg-Vorpommern,50,26,185,426,12.0
2020-04-01 00:00:00+00:00,Mecklenburg-Vorpommern,23,26,184,449,11.0
2020-04-02 00:00:00+00:00,Mecklenburg-Vorpommern,29,27,189,478,12.0
2020-04-03 00:00:00+00:00,Mecklenburg-Vorpommern,31,25,178,509,11.0
2020-04-04 00:00:00+00:00,Mecklenburg-Vorpommern,15,24,172,524,11.0
2020-04-05 00:00:00+00:00,Mecklenburg-Vorpommern,2,23,163,526,10.0
2020-04-06 00:00:00+00:00,Mecklenburg-Vorpommern,5,22,155,531,10.0
2020-04-07 00:00:00+00:00,Mecklenburg-Vorpommern,35,20,140,566,9.0
2020-04-08 00:00:00+00:00,Mecklenburg-Vorpommern,8,17,125,574,8.0
2020-04-09 00:00:00+00:00,Mecklenburg-Vorpommern,15,15,111,589,7.0
2020-04-10 00:00:00+00:00,Mecklenburg-Vorpommern,11,13,91,600,6.0
2020-04-11 00:00:00+00:00,Mecklenburg-Vorpommern,13,12,89,613,6.0
2020-04-12 00:00:00+00:00,Mecklenburg-Vorpommern,3,12,90,616,6.0
2020-04-13 00:00:00+00:00,Mecklenburg-Vorpommern,4,12,89,620,6.0
2020-04-14 00:00:00+00:00,Mecklenburg-Vorpommern,3,8,57,623,4.0
2020-04-15 00:00:00+00:00,Mecklenburg-Vorpommern,11,8,60,634,4.0
2020-04-16 00:00:00+00:00,Mecklenburg-Vorpommern,9,7,54,643,3.0
2020-04-17 00:00:00+00:00,Mecklenburg-Vorpommern,4,6,47,647,3.0
2020-04-18 00:00:00+00:00,Mecklenburg-Vorpommern,6,5,40,653,2.0
2020-04-20 00:00:00+00:00,Mecklenburg-Vorpommern,2,5,39,655,2.0
2020-04-21 00:00:00+00:00,Mecklenburg-Vorpommern,2,5,37,657,2.0
2020-04-22 00:00:00+00:00,Mecklenburg-Vorpommern,4,5,38,661,2.0
2020-04-24 00:00:00+00:00,Mecklenburg-Vorpommern,6,4,33,667,2.0
2020-04-25 00:00:00+00:00,Mecklenburg-Vorpommern,7,4,31,674,2.0
2020-04-27 00:00:00+00:00,Mecklenburg-Vorpommern,1,4,28,675,2.0
2020-04-28 00:00:00+00:00,Mecklenburg-Vorpommern,13,5,35,688,2.0
2020-04-29 00:00:00+00:00,Mecklenburg-Vorpommern,4,5,37,692,2.0
2020-04-30 00:00:00+00:00,Mecklenburg-Vorpommern,4,5,39,696,2.0
2020-05-01 00:00:00+00:00,Mecklenburg-Vorpommern,4,5,39,700,2.0
2020-05-02 00:00:00+00:00,Mecklenburg-Vorpommern,2,5,35,702,2.0
2020-05-04 00:00:00+00:00,Mecklenburg-Vorpommern,4,4,32,706,2.0
2020-05-05 00:00:00+00:00,Mecklenburg-Vorpommern,7,5,38,713,2.0
2020-05-06 00:00:00+00:00,Mecklenburg-Vorpommern,3,4,28,716,2.0
2020-05-07 00:00:00+00:00,Mecklenburg-Vorpommern,6,4,30,722,2.0
2020-05-09 00:00:00+00:00,Mecklenburg-Vorpommern,4,4,30,726,2.0
2020-05-10 00:00:00+00:00,Mecklenburg-Vorpommern,3,4,29,729,2.0
2020-05-11 00:00:00+00:00,Mecklenburg-Vorpommern,3,4,30,732,2.0
2020-05-12 00:00:00+00:00,Mecklenburg-Vorpommern,4,4,30,736,2.0
2020-05-13 00:00:00+00:00,Mecklenburg-Vorpommern,4,3,27,740,2.0
2020-05-14 00:00:00+00:00,Mecklenburg-Vorpommern,5,4,29,745,2.0
2020-05-15 00:00:00+00:00,Mecklenburg-Vorpommern,2,3,25,747,2.0
2020-05-16 00:00:00+00:00,Mecklenburg-Vorpommern,1,3,22,748,1.0
2020-05-17 00:00:00+00:00,Mecklenburg-Vorpommern,1,2,20,749,1.0
2020-05-19 00:00:00+00:00,Mecklenburg-Vorpommern,2,2,19,751,1.0
2020-05-20 00:00:00+00:00,Mecklenburg-Vorpommern,8,3,23,759,1.0
2020-05-25 00:00:00+00:00,Mecklenburg-Vorpommern,1,2,20,760,1.0
2020-05-28 00:00:00+00:00,Mecklenburg-Vorpommern,1,2,16,761,1.0
2020-05-29 00:00:00+00:00,Mecklenburg-Vorpommern,1,2,15,762,1.0
2020-06-03 00:00:00+00:00,Mecklenburg-Vorpommern,2,2,16,764,1.0
2020-06-04 00:00:00+00:00,Mecklenburg-Vorpommern,1,2,16,765,1.0
2020-06-05 00:00:00+00:00,Mecklenburg-Vorpommern,3,2,17,768,1.0
2020-06-06 00:00:00+00:00,Mecklenburg-Vorpommern,7,2,16,775,1.0
2020-06-09 00:00:00+00:00,Mecklenburg-Vorpommern,3,2,18,778,1.0
2020-06-10 00:00:00+00:00,Mecklenburg-Vorpommern,1,2,18,779,1.0
2020-06-11 00:00:00+00:00,Mecklenburg-Vorpommern,2,2,19,781,1.0
2020-06-12 00:00:00+00:00,Mecklenburg-Vorpommern,2,2,19,783,1.0
2020-06-14 00:00:00+00:00,Mecklenburg-Vorpommern,1,2,19,784,1.0
2020-06-15 00:00:00+00:00,Mecklenburg-Vorpommern,2,2,18,786,1.0
2020-06-16 00:00:00+00:00,Mecklenburg-Vorpommern,2,1,13,788,1.0
2020-06-17 00:00:00+00:00,Mecklenburg-Vorpommern,5,2,15,793,1.0
2020-06-19 00:00:00+00:00,Mecklenburg-Vorpommern,1,2,15,794,1.0
2020-06-23 00:00:00+00:00,Mecklenburg-Vorpommern,1,2,14,795,1.0
2020-06-24 00:00:00+00:00,Mecklenburg-Vorpommern,3,2,15,798,1.0
2020-06-25 00:00:00+00:00,Mecklenburg-Vorpommern,1,2,15,799,1.0
2020-06-26 00:00:00+00:00,Mecklenburg-Vorpommern,2,2,15,801,1.0
2020-06-27 00:00:00+00:00,Mecklenburg-Vorpommern,2,2,15,803,1.0
2020-06-29 00:00:00+00:00,Mecklenburg-Vorpommern,1,1,11,804,1.0
2020-06-30 00:00:00+00:00,Mecklenburg-Vorpommern,1,1,11,805,1.0
2020-07-02 00:00:00+00:00,Mecklenburg-Vorpommern,1,1,11,806,1.0
2020-07-15 00:00:00+00:00,Mecklenburg-Vorpommern,1,1,9,807,1.0
2020-07-17 00:00:00+00:00,Mecklenburg-Vorpommern,2,1,10,809,1.0
2020-07-18 00:00:00+00:00,Mecklenburg-Vorpommern,1,1,9,810,1.0
2020-07-19 00:00:00+00:00,Mecklenburg-Vorpommern,2,1,9,812,1.0
2020-07-21 00:00:00+00:00,Mecklenburg-Vorpommern,2,1,10,814,1.0
2020-07-22 00:00:00+00:00,Mecklenburg-Vorpommern,4,1,13,818,1.0
2020-07-23 00:00:00+00:00,Mecklenburg-Vorpommern,11,3,23,829,1.0
2020-07-24 00:00:00+00:00,Mecklenburg-Vorpommern,18,5,40,847,2.0
2020-07-27 00:00:00+00:00,Mecklenburg-Vorpommern,5,6,43,852,3.0
2020-07-28 00:00:00+00:00,Mecklenburg-Vorpommern,3,6,45,855,3.0
2020-07-29 00:00:00+00:00,Mecklenburg-Vorpommern,10,7,53,865,3.0
2020-07-30 00:00:00+00:00,Mecklenburg-Vorpommern,4,7,55,869,3.0
2020-07-31 00:00:00+00:00,Mecklenburg-Vorpommern,3,7,54,872,3.0
2020-08-01 00:00:00+00:00,Mecklenburg-Vorpommern,11,7,54,883,3.0
2020-08-02 00:00:00+00:00,Mecklenburg-Vorpommern,4,5,40,887,2.0
2020-08-03 00:00:00+00:00,Mecklenburg-Vorpommern,4,5,39,891,2.0
2020-08-04 00:00:00+00:00,Mecklenburg-Vorpommern,9,6,45,900,3.0
2020-08-05 00:00:00+00:00,Mecklenburg-Vorpommern,14,7,49,914,3.0
2020-08-06 00:00:00+00:00,Mecklenburg-Vorpommern,15,8,60,929,4.0
2020-08-07 00:00:00+00:00,Mecklenburg-Vorpommern,10,9,67,939,4.0
2020-08-08 00:00:00+00:00,Mecklenburg-Vorpommern,4,8,60,943,4.0
2020-08-10 00:00:00+00:00,Mecklenburg-Vorpommern,6,8,62,949,4.0
2020-08-11 00:00:00+00:00,Mecklenburg-Vorpommern,5,9,63,954,4.0
2020-08-12 00:00:00+00:00,Mecklenburg-Vorpommern,3,8,57,957,4.0
2020-08-13 00:00:00+00:00,Mecklenburg-Vorpommern,5,6,48,962,3.0
2020-08-14 00:00:00+00:00,Mecklenburg-Vorpommern,11,6,44,973,3.0
2020-08-15 00:00:00+00:00,Mecklenburg-Vorpommern,1,5,35,974,2.0
2020-08-16 00:00:00+00:00,Mecklenburg-Vorpommern,1,4,32,975,2.0
2020-08-17 00:00:00+00:00,Mecklenburg-Vorpommern,4,4,30,979,2.0
2020-08-18 00:00:00+00:00,Mecklenburg-Vorpommern,2,3,27,981,2.0
2020-08-19 00:00:00+00:00,Mecklenburg-Vorpommern,3,3,27,984,2.0
2020-08-20 00:00:00+00:00,Mecklenburg-Vorpommern,4,3,26,988,2.0
2020-08-21 00:00:00+00:00,Mecklenburg-Vorpommern,5,2,20,993,1.0
2020-08-22 00:00:00+00:00,Mecklenburg-Vorpommern,3,3,22,996,1.0
2020-08-23 00:00:00+00:00,Mecklenburg-Vorpommern,2,3,23,998,1.0
2020-08-24 00:00:00+00:00,Mecklenburg-Vorpommern,2,3,21,1000,1.0
2020-08-25 00:00:00+00:00,Mecklenburg-Vorpommern,2,3,21,1002,1.0
2020-08-26 00:00:00+00:00,Mecklenburg-Vorpommern,2,2,20,1004,1.0
2020-08-27 00:00:00+00:00,Mecklenburg-Vorpommern,2,2,18,1006,1.0
2020-08-28 00:00:00+00:00,Mecklenburg-Vorpommern,3,2,16,1009,1.0
2020-08-29 00:00:00+00:00,Mecklenburg-Vorpommern,1,2,14,1010,1.0
2020-08-30 00:00:00+00:00,Mecklenburg-Vorpommern,1,1,13,1011,1.0
2020-09-01 00:00:00+00:00,Mecklenburg-Vorpommern,2,1,13,1013,1.0
2020-09-02 00:00:00+00:00,Mecklenburg-Vorpommern,5,2,16,1018,1.0
2020-09-03 00:00:00+00:00,Mecklenburg-Vorpommern,4,2,18,1022,1.0
2020-09-04 00:00:00+00:00,Mecklenburg-Vorpommern,6,3,22,1028,1.0
2020-09-05 00:00:00+00:00,Mecklenburg-Vorpommern,4,3,23,1032,1.0
2020-09-06 00:00:00+00:00,Mecklenburg-Vorpommern,1,3,23,1033,1.0
2020-09-07 00:00:00+00:00,Mecklenburg-Vorpommern,6,4,28,1039,2.0
2020-09-08 00:00:00+00:00,Mecklenburg-Vorpommern,5,4,31,1044,2.0
2020-09-09 00:00:00+00:00,Mecklenburg-Vorpommern,3,4,29,1047,2.0
2020-09-10 00:00:00+00:00,Mecklenburg-Vorpommern,3,4,28,1050,2.0
2020-09-11 00:00:00+00:00,Mecklenburg-Vorpommern,10,4,32,1060,2.0
2020-09-12 00:00:00+00:00,Mecklenburg-Vorpommern,6,4,34,1066,2.0
2020-09-13 00:00:00+00:00,Mecklenburg-Vorpommern,1,4,34,1067,2.0
2020-09-14 00:00:00+00:00,Mecklenburg-Vorpommern,2,4,30,1069,2.0
2020-09-15 00:00:00+00:00,Mecklenburg-Vorpommern,13,5,38,1082,2.0
2020-09-17 00:00:00+00:00,Mecklenburg-Vorpommern,16,7,51,1098,3.0
2020-09-18 00:00:00+00:00,Mecklenburg-Vorpommern,10,8,58,1108,4.0
2020-09-19 00:00:00+00:00,Mecklenburg-Vorpommern,8,8,56,1116,3.0
2020-09-21 00:00:00+00:00,Mecklenburg-Vorpommern,7,8,57,1123,4.0
2020-09-22 00:00:00+00:00,Mecklenburg-Vorpommern,13,9,69,1136,4.0
2020-09-23 00:00:00+00:00,Mecklenburg-Vorpommern,7,10,74,1143,5.0
2020-09-24 00:00:00+00:00,Mecklenburg-Vorpommern,6,9,67,1149,4.0
2020-09-25 00:00:00+00:00,Mecklenburg-Vorpommern,8,8,59,1157,4.0
2020-09-26 00:00:00+00:00,Mecklenburg-Vorpommern,8,8,57,1165,4.0
2020-09-27 00:00:00+00:00,Mecklenburg-Vorpommern,3,7,52,1168,3.0
2020-09-28 00:00:00+00:00,Mecklenburg-Vorpommern,5,7,50,1173,3.0
2020-09-29 00:00:00+00:00,Mecklenburg-Vorpommern,36,10,73,1209,5.0
2020-09-30 00:00:00+00:00,Mecklenburg-Vorpommern,12,11,78,1221,5.0
2020-10-01 00:00:00+00:00,Mecklenburg-Vorpommern,29,14,101,1250,6.0
2020-10-02 00:00:00+00:00,Mecklenburg-Vorpommern,15,15,108,1265,7.0
2020-10-03 00:00:00+00:00,Mecklenburg-Vorpommern,26,18,126,1291,8.0
2020-10-04 00:00:00+00:00,Mecklenburg-Vorpommern,6,18,129,1297,8.0
2020-10-05 00:00:00+00:00,Mecklenburg-Vorpommern,9,19,133,1306,8.0
2020-10-06 00:00:00+00:00,Mecklenburg-Vorpommern,16,16,113,1322,7.0
2020-10-07 00:00:00+00:00,Mecklenburg-Vorpommern,19,17,120,1341,7.0
2020-10-08 00:00:00+00:00,Mecklenburg-Vorpommern,27,16,118,1368,7.0
2020-10-09 00:00:00+00:00,Mecklenburg-Vorpommern,25,18,128,1393,8.0
2020-10-10 00:00:00+00:00,Mecklenburg-Vorpommern,37,19,139,1430,9.0
2020-10-11 00:00:00+00:00,Mecklenburg-Vorpommern,10,20,143,1440,9.0
2020-10-12 00:00:00+00:00,Mecklenburg-Vorpommern,8,20,142,1448,9.0
2020-10-13 00:00:00+00:00,Mecklenburg-Vorpommern,63,27,189,1511,12.0
2020-10-14 00:00:00+00:00,Mecklenburg-Vorpommern,61,33,231,1572,14.0
2020-10-15 00:00:00+00:00,Mecklenburg-Vorpommern,51,36,255,1623,16.0
2020-10-16 00:00:00+00:00,Mecklenburg-Vorpommern,49,39,279,1672,17.0
2020-10-17 00:00:00+00:00,Mecklenburg-Vorpommern,35,39,277,1707,17.0
2020-10-18 00:00:00+00:00,Mecklenburg-Vorpommern,13,40,280,1720,17.0
2020-10-19 00:00:00+00:00,Mecklenburg-Vorpommern,16,41,288,1736,18.0
2020-10-20 00:00:00+00:00,Mecklenburg-Vorpommern,88,44,313,1824,19.0
2020-10-21 00:00:00+00:00,Mecklenburg-Vorpommern,81,47,333,1905,21.0
2020-10-22 00:00:00+00:00,Mecklenburg-Vorpommern,101,54,383,2006,24.0
2020-10-23 00:00:00+00:00,Mecklenburg-Vorpommern,85,59,419,2091,26.0
2020-10-24 00:00:00+00:00,Mecklenburg-Vorpommern,65,64,449,2156,28.0
2020-10-25 00:00:00+00:00,Mecklenburg-Vorpommern,25,65,461,2181,29.0
2020-10-26 00:00:00+00:00,Mecklenburg-Vorpommern,47,70,492,2228,31.0
2020-10-27 00:00:00+00:00,Mecklenburg-Vorpommern,152,79,556,2380,35.0
2020-10-28 00:00:00+00:00,Mecklenburg-Vorpommern,130,86,605,2510,38.0
2020-10-29 00:00:00+00:00,Mecklenburg-Vorpommern,126,90,630,2636,39.0
2020-10-30 00:00:00+00:00,Mecklenburg-Vorpommern,167,101,712,2803,44.0
2020-10-31 00:00:00+00:00,Mecklenburg-Vorpommern,91,105,738,2894,46.0
2020-11-01 00:00:00+00:00,Mecklenburg-Vorpommern,41,107,754,2935,47.0
2020-11-02 00:00:00+00:00,Mecklenburg-Vorpommern,49,108,756,2984,47.0
2020-11-03 00:00:00+00:00,Mecklenburg-Vorpommern,183,112,787,3167,49.0
2020-11-04 00:00:00+00:00,Mecklenburg-Vorpommern,159,116,816,3326,51.0
2020-11-05 00:00:00+00:00,Mecklenburg-Vorpommern,130,117,820,3456,51.0
2020-11-06 00:00:00+00:00,Mecklenburg-Vorpommern,145,114,798,3601,50.0
2020-11-07 00:00:00+00:00,Mecklenburg-Vorpommern,117,117,824,3718,51.0
2020-11-08 00:00:00+00:00,Mecklenburg-Vorpommern,38,117,821,3756,51.0
2020-11-09 00:00:00+00:00,Mecklenburg-Vorpommern,40,116,812,3796,50.0
2020-11-10 00:00:00+00:00,Mecklenburg-Vorpommern,124,107,753,3920,47.0
2020-11-11 00:00:00+00:00,Mecklenburg-Vorpommern,119,101,713,4039,44.0
2020-11-12 00:00:00+00:00,Mecklenburg-Vorpommern,166,107,749,4205,47.0
2020-11-13 00:00:00+00:00,Mecklenburg-Vorpommern,116,102,720,4321,45.0
2020-11-14 00:00:00+00:00,Mecklenburg-Vorpommern,87,98,690,4408,43.0
2020-11-15 00:00:00+00:00,Mecklenburg-Vorpommern,32,97,684,4440,43.0
2020-11-16 00:00:00+00:00,Mecklenburg-Vorpommern,25,95,669,4465,42.0
2020-11-17 00:00:00+00:00,Mecklenburg-Vorpommern,169,102,714,4634,44.0
2020-11-18 00:00:00+00:00,Mecklenburg-Vorpommern,165,108,760,4799,47.0
2020-11-19 00:00:00+00:00,Mecklenburg-Vorpommern,141,105,735,4940,46.0
2020-11-20 00:00:00+00:00,Mecklenburg-Vorpommern,136,107,755,5076,47.0
2020-11-21 00:00:00+00:00,Mecklenburg-Vorpommern,89,108,757,5165,47.0
2020-11-22 00:00:00+00:00,Mecklenburg-Vorpommern,29,107,754,5194,47.0
2020-11-23 00:00:00+00:00,Mecklenburg-Vorpommern,52,111,781,5246,49.0
2020-11-24 00:00:00+00:00,Mecklenburg-Vorpommern,147,108,759,5393,47.0
2020-11-25 00:00:00+00:00,Mecklenburg-Vorpommern,124,102,718,5517,45.0
2020-11-26 00:00:00+00:00,Mecklenburg-Vorpommern,172,107,749,5689,47.0
2020-11-27 00:00:00+00:00,Mecklenburg-Vorpommern,131,106,744,5820,46.0
2020-11-28 00:00:00+00:00,Mecklenburg-Vorpommern,108,109,763,5928,47.0
2020-11-29 00:00:00+00:00,Mecklenburg-Vorpommern,42,110,776,5970,48.0
2020-11-30 00:00:00+00:00,Mecklenburg-Vorpommern,32,108,756,6002,47.0
2020-12-01 00:00:00+00:00,Mecklenburg-Vorpommern,140,107,749,6142,47.0
2020-12-02 00:00:00+00:00,Mecklenburg-Vorpommern,145,110,770,6287,48.0
2020-12-03 00:00:00+00:00,Mecklenburg-Vorpommern,172,110,770,6459,48.0
2020-12-04 00:00:00+00:00,Mecklenburg-Vorpommern,157,113,796,6616,49.0
2020-12-05 00:00:00+00:00,Mecklenburg-Vorpommern,122,115,810,6738,50.0
2020-12-06 00:00:00+00:00,Mecklenburg-Vorpommern,49,116,817,6787,51.0
2020-12-07 00:00:00+00:00,Mecklenburg-Vorpommern,64,121,849,6851,53.0
2020-12-08 00:00:00+00:00,Mecklenburg-Vorpommern,257,138,966,7108,60.0
2020-12-09 00:00:00+00:00,Mecklenburg-Vorpommern,279,157,1100,7387,68.0
2020-12-10 00:00:00+00:00,Mecklenburg-Vorpommern,232,165,1160,7619,72.0
2020-12-11 00:00:00+00:00,Mecklenburg-Vorpommern,286,184,1289,7905,80.0
2020-12-12 00:00:00+00:00,Mecklenburg-Vorpommern,229,199,1396,8134,87.0
2020-12-13 00:00:00+00:00,Mecklenburg-Vorpommern,106,207,1453,8240,90.0
2020-12-14 00:00:00+00:00,Mecklenburg-Vorpommern,87,210,1476,8327,92.0
2020-12-15 00:00:00+00:00,Mecklenburg-Vorpommern,329,221,1548,8656,96.0
2020-12-16 00:00:00+00:00,Mecklenburg-Vorpommern,333,228,1602,8989,100.0
2020-12-17 00:00:00+00:00,Mecklenburg-Vorpommern,282,236,1652,9271,103.0
2020-12-18 00:00:00+00:00,Mecklenburg-Vorpommern,229,227,1595,9500,99.0
2020-12-19 00:00:00+00:00,Mecklenburg-Vorpommern,187,221,1553,9687,97.0
2020-12-20 00:00:00+00:00,Mecklenburg-Vorpommern,123,224,1570,9810,98.0
2020-12-21 00:00:00+00:00,Mecklenburg-Vorpommern,116,228,1599,9926,99.0
2020-12-22 00:00:00+00:00,Mecklenburg-Vorpommern,371,234,1641,10297,102.0
2020-12-23 00:00:00+00:00,Mecklenburg-Vorpommern,271,225,1579,10568,98.0
2020-12-24 00:00:00+00:00,Mecklenburg-Vorpommern,151,206,1448,10719,90.0
2020-12-25 00:00:00+00:00,Mecklenburg-Vorpommern,160,197,1379,10879,86.0
2020-12-26 00:00:00+00:00,Mecklenburg-Vorpommern,115,186,1307,10994,81.0
2020-12-27 00:00:00+00:00,Mecklenburg-Vorpommern,94,182,1278,11088,79.0
2020-12-28 00:00:00+00:00,Mecklenburg-Vorpommern,97,179,1259,11185,78.0
2020-12-29 00:00:00+00:00,Mecklenburg-Vorpommern,483,195,1371,11668,85.0
2020-12-30 00:00:00+00:00,Mecklenburg-Vorpommern,380,211,1480,12048,92.0
2020-12-31 00:00:00+00:00,Mecklenburg-Vorpommern,238,223,1567,12286,97.0
2021-01-01 00:00:00+00:00,Mecklenburg-Vorpommern,140,221,1547,12426,96.0
2021-01-02 00:00:00+00:00,Mecklenburg-Vorpommern,102,219,1534,12528,95.0
2021-01-03 00:00:00+00:00,Mecklenburg-Vorpommern,68,215,1508,12596,94.0
2021-01-04 00:00:00+00:00,Mecklenburg-Vorpommern,207,231,1618,12803,101.0
2021-01-05 00:00:00+00:00,Mecklenburg-Vorpommern,554,241,1689,13357,105.0
2021-01-06 00:00:00+00:00,Mecklenburg-Vorpommern,447,250,1756,13804,109.0
2021-01-07 00:00:00+00:00,Mecklenburg-Vorpommern,275,256,1793,14079,111.0
2021-01-08 00:00:00+00:00,Mecklenburg-Vorpommern,429,297,2082,14508,129.0
2021-01-09 00:00:00+00:00,Mecklenburg-Vorpommern,192,310,2172,14700,135.0
2021-01-10 00:00:00+00:00,Mecklenburg-Vorpommern,78,311,2182,14778,136.0
2021-01-11 00:00:00+00:00,Mecklenburg-Vorpommern,197,310,2172,14975,135.0
2021-01-12 00:00:00+00:00,Mecklenburg-Vorpommern,394,287,2012,15369,125.0
2021-01-13 00:00:00+00:00,Mecklenburg-Vorpommern,354,274,1919,15723,119.0
2021-01-14 00:00:00+00:00,Mecklenburg-Vorpommern,366,287,2010,16089,125.0
2021-01-15 00:00:00+00:00,Mecklenburg-Vorpommern,311,270,1892,16400,118.0
2021-01-16 00:00:00+00:00,Mecklenburg-Vorpommern,234,276,1934,16634,120.0
2021-01-17 00:00:00+00:00,Mecklenburg-Vorpommern,110,280,1966,16744,122.0
2021-01-18 00:00:00+00:00,Mecklenburg-Vorpommern,171,277,1940,16915,121.0
2021-01-19 00:00:00+00:00,Mecklenburg-Vorpommern,367,273,1913,17282,119.0
2021-01-20 00:00:00+00:00,Mecklenburg-Vorpommern,289,264,1848,17571,115.0
2021-01-21 00:00:00+00:00,Mecklenburg-Vorpommern,270,250,1752,17841,109.0
2021-01-22 00:00:00+00:00,Mecklenburg-Vorpommern,277,245,1718,18118,107.0
2021-01-23 00:00:00+00:00,Mecklenburg-Vorpommern,219,243,1703,18337,106.0
2021-01-24 00:00:00+00:00,Mecklenburg-Vorpommern,134,246,1727,18471,107.0
2021-01-25 00:00:00+00:00,Mecklenburg-Vorpommern,106,237,1662,18577,103.0
2021-01-26 00:00:00+00:00,Mecklenburg-Vorpommern,394,241,1689,18971,105.0
2021-01-27 00:00:00+00:00,Mecklenburg-Vorpommern,232,233,1632,19203,101.0
2021-01-28 00:00:00+00:00,Mecklenburg-Vorpommern,241,229,1603,19444,100.0
2021-01-29 00:00:00+00:00,Mecklenburg-Vorpommern,250,225,1576,19694,98.0
2021-01-30 00:00:00+00:00,Mecklenburg-Vorpommern,145,214,1502,19839,93.0
2021-01-31 00:00:00+00:00,Mecklenburg-Vorpommern,88,208,1456,19927,91.0
2021-02-01 00:00:00+00:00,Mecklenburg-Vorpommern,98,206,1448,20025,90.0
2021-02-02 00:00:00+00:00,Mecklenburg-Vorpommern,283,191,1337,20308,83.0
2021-02-03 00:00:00+00:00,Mecklenburg-Vorpommern,305,201,1410,20613,88.0
2021-02-04 00:00:00+00:00,Mecklenburg-Vorpommern,241,201,1410,20854,88.0
2021-02-05 00:00:00+00:00,Mecklenburg-Vorpommern,225,197,1385,21079,86.0
2021-02-06 00:00:00+00:00,Mecklenburg-Vorpommern,124,194,1364,21203,85.0
2021-02-07 00:00:00+00:00,Mecklenburg-Vorpommern,80,193,1356,21283,84.0
2021-02-08 00:00:00+00:00,Mecklenburg-Vorpommern,87,192,1345,21370,84.0
2021-02-09 00:00:00+00:00,Mecklenburg-Vorpommern,223,183,1285,21593,80.0
2021-02-10 00:00:00+00:00,Mecklenburg-Vorpommern,195,167,1175,21788,73.0
2021-02-11 00:00:00+00:00,Mecklenburg-Vorpommern,184,159,1118,21972,70.0
2021-02-12 00:00:00+00:00,Mecklenburg-Vorpommern,159,150,1052,22131,65.0
2021-02-13 00:00:00+00:00,Mecklenburg-Vorpommern,148,153,1076,22279,67.0
2021-02-14 00:00:00+00:00,Mecklenburg-Vorpommern,62,151,1058,22341,66.0
2021-02-15 00:00:00+00:00,Mecklenburg-Vorpommern,80,150,1051,22421,65.0
2021-02-16 00:00:00+00:00,Mecklenburg-Vorpommern,248,153,1076,22669,67.0
2021-02-17 00:00:00+00:00,Mecklenburg-Vorpommern,220,157,1101,22889,68.0
2021-02-18 00:00:00+00:00,Mecklenburg-Vorpommern,205,160,1122,23094,70.0
2021-02-19 00:00:00+00:00,Mecklenburg-Vorpommern,230,170,1193,23324,74.0
2021-02-20 00:00:00+00:00,Mecklenburg-Vorpommern,112,165,1157,23436,72.0
2021-02-21 00:00:00+00:00,Mecklenburg-Vorpommern,54,164,1149,23490,71.0
2021-02-22 00:00:00+00:00,Mecklenburg-Vorpommern,55,160,1124,23545,70.0
2021-02-23 00:00:00+00:00,Mecklenburg-Vorpommern,279,165,1155,23824,72.0
2021-02-24 00:00:00+00:00,Mecklenburg-Vorpommern,192,161,1127,24016,70.0
2021-02-25 00:00:00+00:00,Mecklenburg-Vorpommern,182,157,1104,24198,69.0
2021-02-26 00:00:00+00:00,Mecklenburg-Vorpommern,208,154,1082,24406,67.0
2021-02-27 00:00:00+00:00,Mecklenburg-Vorpommern,177,163,1147,24583,71.0
2021-02-28 00:00:00+00:00,Mecklenburg-Vorpommern,29,160,1122,24612,70.0
2021-03-01 00:00:00+00:00,Mecklenburg-Vorpommern,87,164,1154,24699,72.0
2021-03-02 00:00:00+00:00,Mecklenburg-Vorpommern,257,161,1132,24956,70.0
2021-03-03 00:00:00+00:00,Mecklenburg-Vorpommern,249,169,1189,25205,74.0
2021-03-04 00:00:00+00:00,Mecklenburg-Vorpommern,170,168,1177,25375,73.0
2021-03-05 00:00:00+00:00,Mecklenburg-Vorpommern,239,172,1208,25614,75.0
2021-03-06 00:00:00+00:00,Mecklenburg-Vorpommern,93,160,1124,25707,70.0
2021-03-07 00:00:00+00:00,Mecklenburg-Vorpommern,27,160,1122,25734,70.0
2021-03-08 00:00:00+00:00,Mecklenburg-Vorpommern,62,156,1097,25796,68.0
2021-03-09 00:00:00+00:00,Mecklenburg-Vorpommern,264,157,1104,26060,69.0
2021-03-10 00:00:00+00:00,Mecklenburg-Vorpommern,203,151,1058,26263,66.0
2021-03-11 00:00:00+00:00,Mecklenburg-Vorpommern,192,154,1080,26455,67.0
2021-03-12 00:00:00+00:00,Mecklenburg-Vorpommern,206,149,1047,26661,65.0
2021-03-13 00:00:00+00:00,Mecklenburg-Vorpommern,164,159,1118,26825,70.0
2021-03-14 00:00:00+00:00,Mecklenburg-Vorpommern,20,158,1111,26845,69.0
2021-03-15 00:00:00+00:00,Mecklenburg-Vorpommern,67,159,1116,26912,69.0
2021-03-16 00:00:00+00:00,Mecklenburg-Vorpommern,300,164,1152,27212,72.0
2021-03-17 00:00:00+00:00,Mecklenburg-Vorpommern,224,167,1173,27436,73.0
2021-03-18 00:00:00+00:00,Mecklenburg-Vorpommern,206,169,1187,27642,74.0
2021-03-19 00:00:00+00:00,Mecklenburg-Vorpommern,261,177,1242,27903,77.0
2021-03-20 00:00:00+00:00,Mecklenburg-Vorpommern,225,186,1303,28128,81.0
2021-03-21 00:00:00+00:00,Mecklenburg-Vorpommern,56,191,1339,28184,83.0
2021-03-22 00:00:00+00:00,Mecklenburg-Vorpommern,108,197,1380,28292,86.0
2021-03-23 00:00:00+00:00,Mecklenburg-Vorpommern,428,215,1508,28720,94.0
2021-03-24 00:00:00+00:00,Mecklenburg-Vorpommern,393,239,1677,29113,104.0
2021-03-25 00:00:00+00:00,Mecklenburg-Vorpommern,363,262,1834,29476,114.0
2021-03-26 00:00:00+00:00,Mecklenburg-Vorpommern,353,275,1926,29829,120.0
2021-03-27 00:00:00+00:00,Mecklenburg-Vorpommern,216,273,1917,30045,119.0
2021-03-28 00:00:00+00:00,Mecklenburg-Vorpommern,70,275,1931,30115,120.0
2021-03-29 00:00:00+00:00,Mecklenburg-Vorpommern,113,276,1936,30228,120.0
2021-03-30 00:00:00+00:00,Mecklenburg-Vorpommern,465,281,1973,30693,123.0
2021-03-31 00:00:00+00:00,Mecklenburg-Vorpommern,249,261,1829,30942,114.0
2021-04-01 00:00:00+00:00,Mecklenburg-Vorpommern,316,254,1782,31258,111.0
2021-04-02 00:00:00+00:00,Mecklenburg-Vorpommern,314,249,1743,31572,108.0
2021-04-03 00:00:00+00:00,Mecklenburg-Vorpommern,96,231,1623,31668,101.0
2021-04-04 00:00:00+00:00,Mecklenburg-Vorpommern,191,249,1744,31859,108.0
2021-04-05 00:00:00+00:00,Mecklenburg-Vorpommern,111,248,1742,31970,108.0
2021-04-06 00:00:00+00:00,Mecklenburg-Vorpommern,115,198,1392,32085,87.0
2021-04-07 00:00:00+00:00,Mecklenburg-Vorpommern,468,230,1611,32553,100.0
2021-04-08 00:00:00+00:00,Mecklenburg-Vorpommern,476,253,1771,33029,110.0
2021-04-09 00:00:00+00:00,Mecklenburg-Vorpommern,469,275,1926,33498,120.0
2021-04-10 00:00:00+00:00,Mecklenburg-Vorpommern,290,302,2120,33788,132.0
2021-04-11 00:00:00+00:00,Mecklenburg-Vorpommern,137,295,2066,33925,128.0
2021-04-12 00:00:00+00:00,Mecklenburg-Vorpommern,234,312,2189,34159,136.0
2021-04-13 00:00:00+00:00,Mecklenburg-Vorpommern,560,376,2634,34719,164.0
2021-04-14 00:00:00+00:00,Mecklenburg-Vorpommern,444,372,2610,35163,162.0
2021-04-15 00:00:00+00:00,Mecklenburg-Vorpommern,438,367,2572,35601,160.0
2021-04-16 00:00:00+00:00,Mecklenburg-Vorpommern,396,357,2499,35997,155.0
2021-04-17 00:00:00+00:00,Mecklenburg-Vorpommern,278,355,2487,36275,155.0
2021-04-18 00:00:00+00:00,Mecklenburg-Vorpommern,111,351,2461,36386,153.0
2021-04-19 00:00:00+00:00,Mecklenburg-Vorpommern,142,338,2369,36528,147.0
2021-04-20 00:00:00+00:00,Mecklenburg-Vorpommern,535,334,2344,37063,146.0
2021-04-21 00:00:00+00:00,Mecklenburg-Vorpommern,473,339,2373,37536,148.0
2021-04-22 00:00:00+00:00,Mecklenburg-Vorpommern,424,337,2359,37960,147.0
2021-04-23 00:00:00+00:00,Mecklenburg-Vorpommern,372,333,2335,38332,145.0
2021-04-24 00:00:00+00:00,Mecklenburg-Vorpommern,238,327,2295,38570,143.0
2021-04-25 00:00:00+00:00,Mecklenburg-Vorpommern,80,323,2264,38650,141.0
2021-04-26 00:00:00+00:00,Mecklenburg-Vorpommern,103,317,2225,38753,138.0
2021-04-27 00:00:00+00:00,Mecklenburg-Vorpommern,602,327,2292,39355,143.0
2021-04-28 00:00:00+00:00,Mecklenburg-Vorpommern,322,305,2141,39677,133.0
2021-04-29 00:00:00+00:00,Mecklenburg-Vorpommern,307,289,2024,39984,126.0
2021-04-30 00:00:00+00:00,Mecklenburg-Vorpommern,352,286,2004,40336,125.0
2021-05-01 00:00:00+00:00,Mecklenburg-Vorpommern,199,280,1965,40535,122.0
2021-05-02 00:00:00+00:00,Mecklenburg-Vorpommern,70,279,1955,40605,122.0
2021-05-03 00:00:00+00:00,Mecklenburg-Vorpommern,100,278,1952,40705,121.0
2021-05-04 00:00:00+00:00,Mecklenburg-Vorpommern,394,249,1744,41099,108.0
2021-05-05 00:00:00+00:00,Mecklenburg-Vorpommern,257,239,1679,41356,104.0
2021-05-06 00:00:00+00:00,Mecklenburg-Vorpommern,226,228,1598,41582,99.0
2021-05-07 00:00:00+00:00,Mecklenburg-Vorpommern,249,213,1495,41831,93.0
2021-05-08 00:00:00+00:00,Mecklenburg-Vorpommern,138,204,1434,41969,89.0
2021-05-09 00:00:00+00:00,Mecklenburg-Vorpommern,55,202,1419,42024,88.0
2021-05-10 00:00:00+00:00,Mecklenburg-Vorpommern,64,197,1383,42088,86.0
2021-05-11 00:00:00+00:00,Mecklenburg-Vorpommern,288,182,1277,42376,79.0
2021-05-12 00:00:00+00:00,Mecklenburg-Vorpommern,204,174,1224,42580,76.0
2021-05-13 00:00:00+00:00,Mecklenburg-Vorpommern,175,167,1173,42755,73.0
2021-05-14 00:00:00+00:00,Mecklenburg-Vorpommern,46,138,970,42801,60.0
2021-05-15 00:00:00+00:00,Mecklenburg-Vorpommern,118,135,950,42919,59.0
2021-05-16 00:00:00+00:00,Mecklenburg-Vorpommern,48,134,943,42967,59.0
2021-05-17 00:00:00+00:00,Mecklenburg-Vorpommern,42,131,921,43009,57.0
2021-05-18 00:00:00+00:00,Mecklenburg-Vorpommern,236,124,869,43245,54.0
2021-05-19 00:00:00+00:00,Mecklenburg-Vorpommern,96,108,761,43341,47.0
2021-05-20 00:00:00+00:00,Mecklenburg-Vorpommern,106,98,692,43447,43.0
2021-05-21 00:00:00+00:00,Mecklenburg-Vorpommern,79,103,725,43526,45.0
2021-05-22 00:00:00+00:00,Mecklenburg-Vorpommern,69,96,676,43595,42.0
2021-05-23 00:00:00+00:00,Mecklenburg-Vorpommern,12,91,640,43607,40.0
2021-05-24 00:00:00+00:00,Mecklenburg-Vorpommern,8,86,606,43615,38.0
2021-05-25 00:00:00+00:00,Mecklenburg-Vorpommern,10,54,380,43625,24.0
2021-05-26 00:00:00+00:00,Mecklenburg-Vorpommern,78,51,362,43703,23.0
2021-05-27 00:00:00+00:00,Mecklenburg-Vorpommern,53,44,309,43756,19.0
2021-05-28 00:00:00+00:00,Mecklenburg-Vorpommern,58,41,288,43814,18.0
2021-05-29 00:00:00+00:00,Mecklenburg-Vorpommern,24,34,243,43838,15.0
2021-05-30 00:00:00+00:00,Mecklenburg-Vorpommern,7,34,238,43845,15.0
2021-05-31 00:00:00+00:00,Mecklenburg-Vorpommern,6,33,236,43851,15.0
2021-06-01 00:00:00+00:00,Mecklenburg-Vorpommern,58,40,284,43909,18.0
2021-06-02 00:00:00+00:00,Mecklenburg-Vorpommern,21,32,227,43930,14.0
2021-06-03 00:00:00+00:00,Mecklenburg-Vorpommern,13,26,187,43943,12.0
2021-06-04 00:00:00+00:00,Mecklenburg-Vorpommern,22,21,151,43965,9.0
2021-06-05 00:00:00+00:00,Mecklenburg-Vorpommern,16,20,143,43981,9.0
2021-06-06 00:00:00+00:00,Mecklenburg-Vorpommern,3,19,139,43984,9.0
2021-06-07 00:00:00+00:00,Mecklenburg-Vorpommern,9,20,142,43993,9.0
2021-06-08 00:00:00+00:00,Mecklenburg-Vorpommern,16,14,100,44009,6.0
2021-06-09 00:00:00+00:00,Mecklenburg-Vorpommern,13,13,92,44022,6.0
2021-06-10 00:00:00+00:00,Mecklenburg-Vorpommern,17,13,96,44039,6.0
2021-06-11 00:00:00+00:00,Mecklenburg-Vorpommern,12,12,86,44051,5.0
2021-06-12 00:00:00+00:00,Mecklenburg-Vorpommern,11,11,81,44062,5.0
2021-06-13 00:00:00+00:00,Mecklenburg-Vorpommern,3,11,81,44065,5.0
2021-06-14 00:00:00+00:00,Mecklenburg-Vorpommern,3,10,75,44068,5.0
2021-06-15 00:00:00+00:00,Mecklenburg-Vorpommern,12,10,71,44080,4.0
2021-06-16 00:00:00+00:00,Mecklenburg-Vorpommern,7,9,65,44087,4.0
2021-06-17 00:00:00+00:00,Mecklenburg-Vorpommern,4,7,52,44091,3.0
2021-06-18 00:00:00+00:00,Mecklenburg-Vorpommern,5,6,45,44096,3.0
2021-06-19 00:00:00+00:00,Mecklenburg-Vorpommern,2,5,36,44098,2.0
2021-06-20 00:00:00+00:00,Mecklenburg-Vorpommern,2,5,35,44100,2.0
2021-06-21 00:00:00+00:00,Mecklenburg-Vorpommern,1,4,33,44101,2.0
2021-06-22 00:00:00+00:00,Mecklenburg-Vorpommern,13,4,34,44114,2.0
2021-06-23 00:00:00+00:00,Mecklenburg-Vorpommern,5,4,32,44119,2.0
2021-06-24 00:00:00+00:00,Mecklenburg-Vorpommern,2,4,30,44121,2.0
2021-06-25 00:00:00+00:00,Mecklenburg-Vorpommern,9,4,34,44130,2.0
2021-06-26 00:00:00+00:00,Mecklenburg-Vorpommern,2,4,34,44132,2.0
2021-06-27 00:00:00+00:00,Mecklenburg-Vorpommern,2,4,34,44134,2.0
2021-06-28 00:00:00+00:00,Mecklenburg-Vorpommern,1,4,34,44135,2.0
2021-06-29 00:00:00+00:00,Mecklenburg-Vorpommern,5,3,26,44140,2.0
2021-06-30 00:00:00+00:00,Mecklenburg-Vorpommern,6,3,27,44146,2.0
2021-07-01 00:00:00+00:00,Mecklenburg-Vorpommern,2,3,27,44148,2.0
2021-07-02 00:00:00+00:00,Mecklenburg-Vorpommern,4,3,22,44152,1.0
2021-07-03 00:00:00+00:00,Mecklenburg-Vorpommern,2,3,22,44154,1.0
2021-07-04 00:00:00+00:00,Mecklenburg-Vorpommern,1,3,21,44155,1.0
2021-07-05 00:00:00+00:00,Mecklenburg-Vorpommern,1,3,21,44156,1.0
2021-07-06 00:00:00+00:00,Mecklenburg-Vorpommern,3,2,19,44159,1.0
2020-03-10 00:00:00+00:00,Sachsen-Anhalt,6,0,0,6,0.0
2020-03-11 00:00:00+00:00,Sachsen-Anhalt,14,0,0,20,0.0
2020-03-12 00:00:00+00:00,Sachsen-Anhalt,13,0,0,33,0.0
2020-03-13 00:00:00+00:00,Sachsen-Anhalt,11,0,0,44,0.0
2020-03-14 00:00:00+00:00,Sachsen-Anhalt,2,0,0,46,0.0
2020-03-16 00:00:00+00:00,Sachsen-Anhalt,34,0,0,80,0.0
2020-03-17 00:00:00+00:00,Sachsen-Anhalt,29,15,109,109,5.0
2020-03-18 00:00:00+00:00,Sachsen-Anhalt,38,20,141,147,6.0
2020-03-19 00:00:00+00:00,Sachsen-Anhalt,43,24,170,190,8.0
2020-03-20 00:00:00+00:00,Sachsen-Anhalt,51,29,208,241,9.0
2020-03-21 00:00:00+00:00,Sachsen-Anhalt,18,30,215,259,10.0
2020-03-22 00:00:00+00:00,Sachsen-Anhalt,14,32,227,273,10.0
2020-03-23 00:00:00+00:00,Sachsen-Anhalt,66,37,259,339,12.0
2020-03-24 00:00:00+00:00,Sachsen-Anhalt,62,41,292,401,13.0
2020-03-25 00:00:00+00:00,Sachsen-Anhalt,51,43,305,452,14.0
2020-03-26 00:00:00+00:00,Sachsen-Anhalt,58,45,320,510,15.0
2020-03-27 00:00:00+00:00,Sachsen-Anhalt,78,49,347,588,16.0
2020-03-28 00:00:00+00:00,Sachsen-Anhalt,42,53,371,630,17.0
2020-03-29 00:00:00+00:00,Sachsen-Anhalt,19,53,376,649,17.0
2020-03-30 00:00:00+00:00,Sachsen-Anhalt,72,54,382,721,17.0
2020-03-31 00:00:00+00:00,Sachsen-Anhalt,56,53,376,777,17.0
2020-04-01 00:00:00+00:00,Sachsen-Anhalt,36,51,361,813,16.0
2020-04-02 00:00:00+00:00,Sachsen-Anhalt,46,49,349,859,16.0
2020-04-03 00:00:00+00:00,Sachsen-Anhalt,44,45,315,903,14.0
2020-04-04 00:00:00+00:00,Sachsen-Anhalt,34,43,307,937,14.0
2020-04-05 00:00:00+00:00,Sachsen-Anhalt,39,46,327,976,15.0
2020-04-06 00:00:00+00:00,Sachsen-Anhalt,26,40,281,1002,13.0
2020-04-07 00:00:00+00:00,Sachsen-Anhalt,45,38,270,1047,12.0
2020-04-08 00:00:00+00:00,Sachsen-Anhalt,48,40,282,1095,13.0
2020-04-09 00:00:00+00:00,Sachsen-Anhalt,39,39,275,1134,13.0
2020-04-10 00:00:00+00:00,Sachsen-Anhalt,25,36,256,1159,12.0
2020-04-11 00:00:00+00:00,Sachsen-Anhalt,28,35,250,1187,11.0
2020-04-12 00:00:00+00:00,Sachsen-Anhalt,13,32,224,1200,10.0
2020-04-13 00:00:00+00:00,Sachsen-Anhalt,11,29,209,1211,10.0
2020-04-14 00:00:00+00:00,Sachsen-Anhalt,24,26,188,1235,9.0
2020-04-15 00:00:00+00:00,Sachsen-Anhalt,21,23,161,1256,7.0
2020-04-16 00:00:00+00:00,Sachsen-Anhalt,25,21,147,1281,7.0
2020-04-17 00:00:00+00:00,Sachsen-Anhalt,61,26,183,1342,8.0
2020-04-18 00:00:00+00:00,Sachsen-Anhalt,23,25,178,1365,8.0
2020-04-19 00:00:00+00:00,Sachsen-Anhalt,15,25,180,1380,8.0
2020-04-20 00:00:00+00:00,Sachsen-Anhalt,13,26,182,1393,8.0
2020-04-21 00:00:00+00:00,Sachsen-Anhalt,29,26,187,1422,9.0
2020-04-22 00:00:00+00:00,Sachsen-Anhalt,16,26,182,1438,8.0
2020-04-23 00:00:00+00:00,Sachsen-Anhalt,29,26,186,1467,8.0
2020-04-24 00:00:00+00:00,Sachsen-Anhalt,23,21,148,1490,7.0
2020-04-25 00:00:00+00:00,Sachsen-Anhalt,19,20,144,1509,7.0
2020-04-26 00:00:00+00:00,Sachsen-Anhalt,5,19,134,1514,6.0
2020-04-27 00:00:00+00:00,Sachsen-Anhalt,6,18,127,1520,6.0
2020-04-28 00:00:00+00:00,Sachsen-Anhalt,13,15,111,1533,5.0
2020-04-29 00:00:00+00:00,Sachsen-Anhalt,16,15,111,1549,5.0
2020-04-30 00:00:00+00:00,Sachsen-Anhalt,12,13,94,1561,4.0
2020-05-01 00:00:00+00:00,Sachsen-Anhalt,11,11,82,1572,4.0
2020-05-02 00:00:00+00:00,Sachsen-Anhalt,5,9,68,1577,3.0
2020-05-03 00:00:00+00:00,Sachsen-Anhalt,4,9,67,1581,3.0
2020-05-04 00:00:00+00:00,Sachsen-Anhalt,5,9,66,1586,3.0
2020-05-05 00:00:00+00:00,Sachsen-Anhalt,19,10,72,1605,3.0
2020-05-06 00:00:00+00:00,Sachsen-Anhalt,10,9,66,1615,3.0
2020-05-07 00:00:00+00:00,Sachsen-Anhalt,12,9,66,1627,3.0
2020-05-08 00:00:00+00:00,Sachsen-Anhalt,8,9,63,1635,3.0
2020-05-09 00:00:00+00:00,Sachsen-Anhalt,4,8,62,1639,3.0
2020-05-10 00:00:00+00:00,Sachsen-Anhalt,2,8,60,1641,3.0
2020-05-11 00:00:00+00:00,Sachsen-Anhalt,2,8,57,1643,3.0
2020-05-12 00:00:00+00:00,Sachsen-Anhalt,7,6,45,1650,2.0
2020-05-13 00:00:00+00:00,Sachsen-Anhalt,9,6,44,1659,2.0
2020-05-14 00:00:00+00:00,Sachsen-Anhalt,10,6,42,1669,2.0
2020-05-15 00:00:00+00:00,Sachsen-Anhalt,1,5,35,1670,2.0
2020-05-16 00:00:00+00:00,Sachsen-Anhalt,3,4,34,1673,2.0
2020-05-17 00:00:00+00:00,Sachsen-Anhalt,2,4,34,1675,2.0
2020-05-19 00:00:00+00:00,Sachsen-Anhalt,8,5,40,1683,2.0
2020-05-20 00:00:00+00:00,Sachsen-Anhalt,3,5,36,1686,2.0
2020-05-21 00:00:00+00:00,Sachsen-Anhalt,3,4,30,1689,1.0
2020-05-22 00:00:00+00:00,Sachsen-Anhalt,1,3,21,1690,1.0
2020-05-25 00:00:00+00:00,Sachsen-Anhalt,5,3,25,1695,1.0
2020-05-26 00:00:00+00:00,Sachsen-Anhalt,1,3,23,1696,1.0
2020-05-27 00:00:00+00:00,Sachsen-Anhalt,2,3,23,1698,1.0
2020-05-28 00:00:00+00:00,Sachsen-Anhalt,1,2,16,1699,1.0
2020-05-29 00:00:00+00:00,Sachsen-Anhalt,1,2,14,1700,1.0
2020-05-30 00:00:00+00:00,Sachsen-Anhalt,3,2,14,1703,1.0
2020-06-01 00:00:00+00:00,Sachsen-Anhalt,1,2,14,1704,1.0
2020-06-02 00:00:00+00:00,Sachsen-Anhalt,3,1,12,1707,1.0
2020-06-04 00:00:00+00:00,Sachsen-Anhalt,6,2,17,1713,1.0
2020-06-05 00:00:00+00:00,Sachsen-Anhalt,2,2,17,1715,1.0
2020-06-07 00:00:00+00:00,Sachsen-Anhalt,1,2,17,1716,1.0
2020-06-09 00:00:00+00:00,Sachsen-Anhalt,8,3,24,1724,1.0
2020-06-10 00:00:00+00:00,Sachsen-Anhalt,3,3,24,1727,1.0
2020-06-11 00:00:00+00:00,Sachsen-Anhalt,3,3,26,1730,1.0
2020-06-12 00:00:00+00:00,Sachsen-Anhalt,13,5,36,1743,2.0
2020-06-13 00:00:00+00:00,Sachsen-Anhalt,11,5,41,1754,2.0
2020-06-14 00:00:00+00:00,Sachsen-Anhalt,12,7,51,1766,2.0
2020-06-15 00:00:00+00:00,Sachsen-Anhalt,6,8,56,1772,3.0
2020-06-16 00:00:00+00:00,Sachsen-Anhalt,12,8,60,1784,3.0
2020-06-17 00:00:00+00:00,Sachsen-Anhalt,20,11,77,1804,4.0
2020-06-18 00:00:00+00:00,Sachsen-Anhalt,10,12,84,1814,4.0
2020-06-19 00:00:00+00:00,Sachsen-Anhalt,21,13,92,1835,4.0
2020-06-20 00:00:00+00:00,Sachsen-Anhalt,3,12,84,1838,4.0
2020-06-21 00:00:00+00:00,Sachsen-Anhalt,8,11,80,1846,4.0
2020-06-22 00:00:00+00:00,Sachsen-Anhalt,6,11,80,1852,4.0
2020-06-23 00:00:00+00:00,Sachsen-Anhalt,2,10,70,1854,3.0
2020-06-24 00:00:00+00:00,Sachsen-Anhalt,4,7,54,1858,2.0
2020-06-25 00:00:00+00:00,Sachsen-Anhalt,2,6,46,1860,2.0
2020-06-26 00:00:00+00:00,Sachsen-Anhalt,4,4,29,1864,1.0
2020-06-27 00:00:00+00:00,Sachsen-Anhalt,2,4,28,1866,1.0
2020-06-28 00:00:00+00:00,Sachsen-Anhalt,2,3,22,1868,1.0
2020-06-30 00:00:00+00:00,Sachsen-Anhalt,3,2,19,1871,1.0
2020-07-01 00:00:00+00:00,Sachsen-Anhalt,1,2,18,1872,1.0
2020-07-02 00:00:00+00:00,Sachsen-Anhalt,4,2,18,1876,1.0
2020-07-03 00:00:00+00:00,Sachsen-Anhalt,3,2,19,1879,1.0
2020-07-04 00:00:00+00:00,Sachsen-Anhalt,1,2,16,1880,1.0
2020-07-05 00:00:00+00:00,Sachsen-Anhalt,10,3,24,1890,1.0
2020-07-06 00:00:00+00:00,Sachsen-Anhalt,3,3,25,1893,1.0
2020-07-07 00:00:00+00:00,Sachsen-Anhalt,3,3,25,1896,1.0
2020-07-08 00:00:00+00:00,Sachsen-Anhalt,3,3,27,1899,1.0
2020-07-09 00:00:00+00:00,Sachsen-Anhalt,4,3,27,1903,1.0
2020-07-10 00:00:00+00:00,Sachsen-Anhalt,8,4,32,1911,1.0
2020-07-11 00:00:00+00:00,Sachsen-Anhalt,2,4,33,1913,2.0
2020-07-12 00:00:00+00:00,Sachsen-Anhalt,2,3,25,1915,1.0
2020-07-14 00:00:00+00:00,Sachsen-Anhalt,10,4,32,1925,1.0
2020-07-15 00:00:00+00:00,Sachsen-Anhalt,6,5,35,1931,2.0
2020-07-16 00:00:00+00:00,Sachsen-Anhalt,3,5,35,1934,2.0
2020-07-17 00:00:00+00:00,Sachsen-Anhalt,9,5,40,1943,2.0
2020-07-18 00:00:00+00:00,Sachsen-Anhalt,8,5,40,1951,2.0
2020-07-19 00:00:00+00:00,Sachsen-Anhalt,1,5,39,1952,2.0
2020-07-20 00:00:00+00:00,Sachsen-Anhalt,2,5,39,1954,2.0
2020-07-21 00:00:00+00:00,Sachsen-Anhalt,11,5,40,1965,2.0
2020-07-22 00:00:00+00:00,Sachsen-Anhalt,6,5,40,1971,2.0
2020-07-23 00:00:00+00:00,Sachsen-Anhalt,4,5,41,1975,2.0
2020-07-24 00:00:00+00:00,Sachsen-Anhalt,6,5,38,1981,2.0
2020-07-25 00:00:00+00:00,Sachsen-Anhalt,3,4,33,1984,2.0
2020-07-26 00:00:00+00:00,Sachsen-Anhalt,4,5,36,1988,2.0
2020-07-27 00:00:00+00:00,Sachsen-Anhalt,3,5,37,1991,2.0
2020-07-28 00:00:00+00:00,Sachsen-Anhalt,8,4,34,1999,2.0
2020-07-29 00:00:00+00:00,Sachsen-Anhalt,9,5,37,2008,2.0
2020-07-30 00:00:00+00:00,Sachsen-Anhalt,7,5,40,2015,2.0
2020-07-31 00:00:00+00:00,Sachsen-Anhalt,8,6,42,2023,2.0
2020-08-01 00:00:00+00:00,Sachsen-Anhalt,3,6,42,2026,2.0
2020-08-02 00:00:00+00:00,Sachsen-Anhalt,2,5,40,2028,2.0
2020-08-03 00:00:00+00:00,Sachsen-Anhalt,2,5,39,2030,2.0
2020-08-04 00:00:00+00:00,Sachsen-Anhalt,7,5,38,2037,2.0
2020-08-05 00:00:00+00:00,Sachsen-Anhalt,3,4,32,2040,1.0
2020-08-06 00:00:00+00:00,Sachsen-Anhalt,8,4,33,2048,2.0
2020-08-07 00:00:00+00:00,Sachsen-Anhalt,7,4,32,2055,1.0
2020-08-08 00:00:00+00:00,Sachsen-Anhalt,6,5,35,2061,2.0
2020-08-09 00:00:00+00:00,Sachsen-Anhalt,2,5,35,2063,2.0
2020-08-10 00:00:00+00:00,Sachsen-Anhalt,9,6,42,2072,2.0
2020-08-11 00:00:00+00:00,Sachsen-Anhalt,12,6,47,2084,2.0
2020-08-12 00:00:00+00:00,Sachsen-Anhalt,10,7,54,2094,2.0
2020-08-13 00:00:00+00:00,Sachsen-Anhalt,8,7,54,2102,2.0
2020-08-14 00:00:00+00:00,Sachsen-Anhalt,11,8,58,2113,3.0
2020-08-15 00:00:00+00:00,Sachsen-Anhalt,8,8,60,2121,3.0
2020-08-16 00:00:00+00:00,Sachsen-Anhalt,1,8,59,2122,3.0
2020-08-17 00:00:00+00:00,Sachsen-Anhalt,4,7,54,2126,2.0
2020-08-18 00:00:00+00:00,Sachsen-Anhalt,12,7,54,2138,2.0
2020-08-19 00:00:00+00:00,Sachsen-Anhalt,13,8,57,2151,3.0
2020-08-20 00:00:00+00:00,Sachsen-Anhalt,13,8,62,2164,3.0
2020-08-21 00:00:00+00:00,Sachsen-Anhalt,10,8,61,2174,3.0
2020-08-22 00:00:00+00:00,Sachsen-Anhalt,7,8,60,2181,3.0
2020-08-23 00:00:00+00:00,Sachsen-Anhalt,3,8,62,2184,3.0
2020-08-24 00:00:00+00:00,Sachsen-Anhalt,8,9,66,2192,3.0
2020-08-25 00:00:00+00:00,Sachsen-Anhalt,14,9,68,2206,3.0
2020-08-26 00:00:00+00:00,Sachsen-Anhalt,8,9,63,2214,3.0
2020-08-27 00:00:00+00:00,Sachsen-Anhalt,5,7,55,2219,3.0
2020-08-28 00:00:00+00:00,Sachsen-Anhalt,11,8,56,2230,3.0
2020-08-29 00:00:00+00:00,Sachsen-Anhalt,6,7,55,2236,3.0
2020-08-30 00:00:00+00:00,Sachsen-Anhalt,5,8,57,2241,3.0
2020-08-31 00:00:00+00:00,Sachsen-Anhalt,3,7,52,2244,2.0
2020-09-01 00:00:00+00:00,Sachsen-Anhalt,11,7,49,2255,2.0
2020-09-02 00:00:00+00:00,Sachsen-Anhalt,5,6,46,2260,2.0
2020-09-03 00:00:00+00:00,Sachsen-Anhalt,9,7,50,2269,2.0
2020-09-04 00:00:00+00:00,Sachsen-Anhalt,9,6,48,2278,2.0
2020-09-05 00:00:00+00:00,Sachsen-Anhalt,3,6,45,2281,2.0
2020-09-06 00:00:00+00:00,Sachsen-Anhalt,4,6,44,2285,2.0
2020-09-07 00:00:00+00:00,Sachsen-Anhalt,1,6,42,2286,2.0
2020-09-08 00:00:00+00:00,Sachsen-Anhalt,19,7,50,2305,2.0
2020-09-09 00:00:00+00:00,Sachsen-Anhalt,5,7,50,2310,2.0
2020-09-10 00:00:00+00:00,Sachsen-Anhalt,10,7,51,2320,2.0
2020-09-11 00:00:00+00:00,Sachsen-Anhalt,21,9,63,2341,3.0
2020-09-12 00:00:00+00:00,Sachsen-Anhalt,13,10,73,2354,3.0
2020-09-13 00:00:00+00:00,Sachsen-Anhalt,2,10,71,2356,3.0
2020-09-14 00:00:00+00:00,Sachsen-Anhalt,8,11,78,2364,4.0
2020-09-15 00:00:00+00:00,Sachsen-Anhalt,9,9,68,2373,3.0
2020-09-16 00:00:00+00:00,Sachsen-Anhalt,17,11,80,2390,4.0
2020-09-17 00:00:00+00:00,Sachsen-Anhalt,28,14,98,2418,4.0
2020-09-18 00:00:00+00:00,Sachsen-Anhalt,24,14,101,2442,5.0
2020-09-19 00:00:00+00:00,Sachsen-Anhalt,8,13,96,2450,4.0
2020-09-20 00:00:00+00:00,Sachsen-Anhalt,6,14,100,2456,5.0
2020-09-21 00:00:00+00:00,Sachsen-Anhalt,7,14,99,2463,5.0
2020-09-22 00:00:00+00:00,Sachsen-Anhalt,29,17,119,2492,5.0
2020-09-23 00:00:00+00:00,Sachsen-Anhalt,26,18,128,2518,6.0
2020-09-24 00:00:00+00:00,Sachsen-Anhalt,15,16,115,2533,5.0
2020-09-25 00:00:00+00:00,Sachsen-Anhalt,36,18,127,2569,6.0
2020-09-26 00:00:00+00:00,Sachsen-Anhalt,41,22,160,2610,7.0
2020-09-27 00:00:00+00:00,Sachsen-Anhalt,3,22,157,2613,7.0
2020-09-28 00:00:00+00:00,Sachsen-Anhalt,12,23,162,2625,7.0
2020-09-29 00:00:00+00:00,Sachsen-Anhalt,32,23,165,2657,8.0
2020-09-30 00:00:00+00:00,Sachsen-Anhalt,40,25,179,2697,8.0
2020-10-01 00:00:00+00:00,Sachsen-Anhalt,21,26,185,2718,8.0
2020-10-02 00:00:00+00:00,Sachsen-Anhalt,33,26,182,2751,8.0
2020-10-03 00:00:00+00:00,Sachsen-Anhalt,10,21,151,2761,7.0
2020-10-04 00:00:00+00:00,Sachsen-Anhalt,11,22,159,2772,7.0
2020-10-05 00:00:00+00:00,Sachsen-Anhalt,18,23,165,2790,8.0
2020-10-06 00:00:00+00:00,Sachsen-Anhalt,41,24,174,2831,8.0
2020-10-07 00:00:00+00:00,Sachsen-Anhalt,17,21,151,2848,7.0
2020-10-08 00:00:00+00:00,Sachsen-Anhalt,27,22,157,2875,7.0
2020-10-09 00:00:00+00:00,Sachsen-Anhalt,46,24,170,2921,8.0
2020-10-10 00:00:00+00:00,Sachsen-Anhalt,6,23,166,2927,8.0
2020-10-11 00:00:00+00:00,Sachsen-Anhalt,37,27,192,2964,9.0
2020-10-12 00:00:00+00:00,Sachsen-Anhalt,22,28,196,2986,9.0
2020-10-13 00:00:00+00:00,Sachsen-Anhalt,33,26,188,3019,9.0
2020-10-14 00:00:00+00:00,Sachsen-Anhalt,54,32,225,3073,10.0
2020-10-15 00:00:00+00:00,Sachsen-Anhalt,62,37,260,3135,12.0
2020-10-16 00:00:00+00:00,Sachsen-Anhalt,88,43,302,3223,14.0
2020-10-17 00:00:00+00:00,Sachsen-Anhalt,56,50,352,3279,16.0
2020-10-18 00:00:00+00:00,Sachsen-Anhalt,43,51,358,3322,16.0
2020-10-19 00:00:00+00:00,Sachsen-Anhalt,86,60,422,3408,19.0
2020-10-20 00:00:00+00:00,Sachsen-Anhalt,76,66,465,3484,21.0
2020-10-21 00:00:00+00:00,Sachsen-Anhalt,166,82,577,3650,26.0
2020-10-22 00:00:00+00:00,Sachsen-Anhalt,82,85,597,3732,27.0
2020-10-23 00:00:00+00:00,Sachsen-Anhalt,233,106,742,3965,34.0
2020-10-24 00:00:00+00:00,Sachsen-Anhalt,77,109,763,4042,35.0
2020-10-25 00:00:00+00:00,Sachsen-Anhalt,127,121,847,4169,39.0
2020-10-26 00:00:00+00:00,Sachsen-Anhalt,120,125,881,4289,40.0
2020-10-27 00:00:00+00:00,Sachsen-Anhalt,184,141,989,4473,45.0
2020-10-28 00:00:00+00:00,Sachsen-Anhalt,282,157,1105,4755,50.0
2020-10-29 00:00:00+00:00,Sachsen-Anhalt,205,175,1228,4960,56.0
2020-10-30 00:00:00+00:00,Sachsen-Anhalt,236,175,1231,5196,56.0
2020-10-31 00:00:00+00:00,Sachsen-Anhalt,158,187,1312,5354,60.0
2020-11-01 00:00:00+00:00,Sachsen-Anhalt,106,184,1291,5460,59.0
2020-11-02 00:00:00+00:00,Sachsen-Anhalt,124,185,1295,5584,59.0
2020-11-03 00:00:00+00:00,Sachsen-Anhalt,191,186,1302,5775,59.0
2020-11-04 00:00:00+00:00,Sachsen-Anhalt,275,185,1295,6050,59.0
2020-11-05 00:00:00+00:00,Sachsen-Anhalt,314,200,1404,6364,64.0
2020-11-06 00:00:00+00:00,Sachsen-Anhalt,247,202,1415,6611,64.0
2020-11-07 00:00:00+00:00,Sachsen-Anhalt,163,202,1420,6774,65.0
2020-11-08 00:00:00+00:00,Sachsen-Anhalt,104,202,1418,6878,65.0
2020-11-09 00:00:00+00:00,Sachsen-Anhalt,148,206,1442,7026,66.0
2020-11-10 00:00:00+00:00,Sachsen-Anhalt,273,217,1524,7299,69.0
2020-11-11 00:00:00+00:00,Sachsen-Anhalt,269,216,1518,7568,69.0
2020-11-12 00:00:00+00:00,Sachsen-Anhalt,277,211,1481,7845,67.0
2020-11-13 00:00:00+00:00,Sachsen-Anhalt,196,204,1430,8041,65.0
2020-11-14 00:00:00+00:00,Sachsen-Anhalt,203,210,1470,8244,67.0
2020-11-15 00:00:00+00:00,Sachsen-Anhalt,139,215,1505,8383,69.0
2020-11-16 00:00:00+00:00,Sachsen-Anhalt,168,217,1525,8551,69.0
2020-11-17 00:00:00+00:00,Sachsen-Anhalt,332,226,1584,8883,72.0
2020-11-18 00:00:00+00:00,Sachsen-Anhalt,294,229,1609,9177,73.0
2020-11-19 00:00:00+00:00,Sachsen-Anhalt,322,236,1654,9499,75.0
2020-11-20 00:00:00+00:00,Sachsen-Anhalt,305,251,1763,9804,80.0
2020-11-21 00:00:00+00:00,Sachsen-Anhalt,257,259,1817,10061,83.0
2020-11-22 00:00:00+00:00,Sachsen-Anhalt,167,263,1845,10228,84.0
2020-11-23 00:00:00+00:00,Sachsen-Anhalt,285,280,1962,10513,89.0
2020-11-24 00:00:00+00:00,Sachsen-Anhalt,337,281,1967,10850,90.0
2020-11-25 00:00:00+00:00,Sachsen-Anhalt,378,293,2051,11228,93.0
2020-11-26 00:00:00+00:00,Sachsen-Anhalt,423,307,2152,11651,98.0
2020-11-27 00:00:00+00:00,Sachsen-Anhalt,443,327,2290,12094,104.0
2020-11-28 00:00:00+00:00,Sachsen-Anhalt,290,331,2323,12384,106.0
2020-11-29 00:00:00+00:00,Sachsen-Anhalt,202,336,2358,12586,107.0
2020-11-30 00:00:00+00:00,Sachsen-Anhalt,230,329,2303,12816,105.0
2020-12-01 00:00:00+00:00,Sachsen-Anhalt,414,340,2380,13230,108.0
2020-12-02 00:00:00+00:00,Sachsen-Anhalt,518,360,2520,13748,115.0
2020-12-03 00:00:00+00:00,Sachsen-Anhalt,491,369,2588,14239,118.0
2020-12-04 00:00:00+00:00,Sachsen-Anhalt,618,394,2763,14857,126.0
2020-12-05 00:00:00+00:00,Sachsen-Anhalt,297,395,2770,15154,126.0
2020-12-06 00:00:00+00:00,Sachsen-Anhalt,184,393,2752,15338,125.0
2020-12-07 00:00:00+00:00,Sachsen-Anhalt,446,424,2968,15784,135.0
2020-12-08 00:00:00+00:00,Sachsen-Anhalt,581,447,3135,16365,143.0
2020-12-09 00:00:00+00:00,Sachsen-Anhalt,693,472,3310,17058,151.0
2020-12-10 00:00:00+00:00,Sachsen-Anhalt,572,484,3391,17630,155.0
2020-12-11 00:00:00+00:00,Sachsen-Anhalt,628,485,3401,18258,155.0
2020-12-12 00:00:00+00:00,Sachsen-Anhalt,422,503,3526,18680,161.0
2020-12-13 00:00:00+00:00,Sachsen-Anhalt,348,527,3690,19028,168.0
2020-12-14 00:00:00+00:00,Sachsen-Anhalt,499,534,3743,19527,171.0
2020-12-15 00:00:00+00:00,Sachsen-Anhalt,706,552,3868,20233,176.0
2020-12-16 00:00:00+00:00,Sachsen-Anhalt,712,555,3887,20945,177.0
2020-12-17 00:00:00+00:00,Sachsen-Anhalt,962,611,4277,21907,195.0
2020-12-18 00:00:00+00:00,Sachsen-Anhalt,928,653,4577,22835,209.0
2020-12-19 00:00:00+00:00,Sachsen-Anhalt,524,668,4679,23359,213.0
2020-12-20 00:00:00+00:00,Sachsen-Anhalt,487,688,4818,23846,220.0
2020-12-21 00:00:00+00:00,Sachsen-Anhalt,641,708,4960,24487,226.0
2020-12-22 00:00:00+00:00,Sachsen-Anhalt,936,741,5190,25423,236.0
2020-12-23 00:00:00+00:00,Sachsen-Anhalt,979,779,5457,26402,249.0
2020-12-24 00:00:00+00:00,Sachsen-Anhalt,679,739,5174,27081,236.0
2020-12-25 00:00:00+00:00,Sachsen-Anhalt,609,693,4855,27690,221.0
2020-12-26 00:00:00+00:00,Sachsen-Anhalt,387,674,4718,28077,215.0
2020-12-27 00:00:00+00:00,Sachsen-Anhalt,289,645,4520,28366,206.0
2020-12-28 00:00:00+00:00,Sachsen-Anhalt,535,630,4414,28901,201.0
2020-12-29 00:00:00+00:00,Sachsen-Anhalt,961,634,4439,29862,202.0
2020-12-30 00:00:00+00:00,Sachsen-Anhalt,914,624,4374,30776,199.0
2020-12-31 00:00:00+00:00,Sachsen-Anhalt,595,612,4290,31371,195.0
2021-01-01 00:00:00+00:00,Sachsen-Anhalt,686,623,4367,32057,199.0
2021-01-02 00:00:00+00:00,Sachsen-Anhalt,505,640,4485,32562,204.0
2021-01-03 00:00:00+00:00,Sachsen-Anhalt,389,655,4585,32951,209.0
2021-01-04 00:00:00+00:00,Sachsen-Anhalt,647,671,4697,33598,214.0
2021-01-05 00:00:00+00:00,Sachsen-Anhalt,968,672,4704,34566,214.0
2021-01-06 00:00:00+00:00,Sachsen-Anhalt,772,651,4562,35338,208.0
2021-01-07 00:00:00+00:00,Sachsen-Anhalt,1048,716,5015,36386,228.0
2021-01-08 00:00:00+00:00,Sachsen-Anhalt,1066,770,5395,37452,246.0
2021-01-09 00:00:00+00:00,Sachsen-Anhalt,656,792,5546,38108,253.0
2021-01-10 00:00:00+00:00,Sachsen-Anhalt,470,803,5627,38578,256.0
2021-01-11 00:00:00+00:00,Sachsen-Anhalt,787,823,5767,39365,263.0
2021-01-12 00:00:00+00:00,Sachsen-Anhalt,1058,836,5857,40423,267.0
2021-01-13 00:00:00+00:00,Sachsen-Anhalt,1078,880,6163,41501,281.0
2021-01-14 00:00:00+00:00,Sachsen-Anhalt,857,853,5972,42358,272.0
2021-01-15 00:00:00+00:00,Sachsen-Anhalt,772,811,5678,43130,259.0
2021-01-16 00:00:00+00:00,Sachsen-Anhalt,597,802,5619,43727,256.0
2021-01-17 00:00:00+00:00,Sachsen-Anhalt,328,782,5477,44055,250.0
2021-01-18 00:00:00+00:00,Sachsen-Anhalt,550,748,5240,44605,239.0
2021-01-19 00:00:00+00:00,Sachsen-Anhalt,898,725,5080,45503,231.0
2021-01-20 00:00:00+00:00,Sachsen-Anhalt,881,697,4883,46384,222.0
2021-01-21 00:00:00+00:00,Sachsen-Anhalt,893,702,4919,47277,224.0
2021-01-22 00:00:00+00:00,Sachsen-Anhalt,640,683,4787,47917,218.0
2021-01-23 00:00:00+00:00,Sachsen-Anhalt,498,669,4688,48415,214.0
2021-01-24 00:00:00+00:00,Sachsen-Anhalt,265,660,4625,48680,211.0
2021-01-25 00:00:00+00:00,Sachsen-Anhalt,572,663,4647,49252,212.0
2021-01-26 00:00:00+00:00,Sachsen-Anhalt,698,635,4447,49950,203.0
2021-01-27 00:00:00+00:00,Sachsen-Anhalt,705,610,4271,50655,195.0
2021-01-28 00:00:00+00:00,Sachsen-Anhalt,586,566,3964,51241,181.0
2021-01-29 00:00:00+00:00,Sachsen-Anhalt,504,546,3828,51745,174.0
2021-01-30 00:00:00+00:00,Sachsen-Anhalt,393,531,3723,52138,170.0
2021-01-31 00:00:00+00:00,Sachsen-Anhalt,193,521,3651,52331,166.0
2021-02-01 00:00:00+00:00,Sachsen-Anhalt,278,479,3357,52609,153.0
2021-02-02 00:00:00+00:00,Sachsen-Anhalt,544,457,3203,53153,146.0
2021-02-03 00:00:00+00:00,Sachsen-Anhalt,490,426,2988,53643,136.0
2021-02-04 00:00:00+00:00,Sachsen-Anhalt,446,406,2848,54089,130.0
2021-02-05 00:00:00+00:00,Sachsen-Anhalt,415,394,2759,54504,126.0
2021-02-06 00:00:00+00:00,Sachsen-Anhalt,309,382,2675,54813,122.0
2021-02-07 00:00:00+00:00,Sachsen-Anhalt,151,376,2633,54964,120.0
2021-02-08 00:00:00+00:00,Sachsen-Anhalt,172,361,2527,55136,115.0
2021-02-09 00:00:00+00:00,Sachsen-Anhalt,205,312,2188,55341,100.0
2021-02-10 00:00:00+00:00,Sachsen-Anhalt,365,294,2063,55706,94.0
2021-02-11 00:00:00+00:00,Sachsen-Anhalt,307,274,1924,56013,88.0
2021-02-12 00:00:00+00:00,Sachsen-Anhalt,319,261,1828,56332,83.0
2021-02-13 00:00:00+00:00,Sachsen-Anhalt,307,260,1826,56639,83.0
2021-02-14 00:00:00+00:00,Sachsen-Anhalt,139,259,1814,56778,83.0
2021-02-15 00:00:00+00:00,Sachsen-Anhalt,208,264,1850,56986,84.0
2021-02-16 00:00:00+00:00,Sachsen-Anhalt,369,287,2014,57355,92.0
2021-02-17 00:00:00+00:00,Sachsen-Anhalt,360,287,2009,57715,92.0
2021-02-18 00:00:00+00:00,Sachsen-Anhalt,378,297,2080,58093,95.0
2021-02-19 00:00:00+00:00,Sachsen-Anhalt,304,295,2065,58397,94.0
2021-02-20 00:00:00+00:00,Sachsen-Anhalt,305,294,2063,58702,94.0
2021-02-21 00:00:00+00:00,Sachsen-Anhalt,106,290,2030,58808,92.0
2021-02-22 00:00:00+00:00,Sachsen-Anhalt,174,285,1996,58982,91.0
2021-02-23 00:00:00+00:00,Sachsen-Anhalt,359,283,1986,59341,90.0
2021-02-24 00:00:00+00:00,Sachsen-Anhalt,432,294,2058,59773,94.0
2021-02-25 00:00:00+00:00,Sachsen-Anhalt,364,292,2044,60137,93.0
2021-02-26 00:00:00+00:00,Sachsen-Anhalt,341,297,2081,60478,95.0
2021-02-27 00:00:00+00:00,Sachsen-Anhalt,293,295,2069,60771,94.0
2021-02-28 00:00:00+00:00,Sachsen-Anhalt,174,305,2137,60945,97.0
2021-03-01 00:00:00+00:00,Sachsen-Anhalt,131,299,2094,61076,95.0
2021-03-02 00:00:00+00:00,Sachsen-Anhalt,382,302,2117,61458,96.0
2021-03-03 00:00:00+00:00,Sachsen-Anhalt,383,295,2068,61841,94.0
2021-03-04 00:00:00+00:00,Sachsen-Anhalt,386,298,2090,62227,95.0
2021-03-05 00:00:00+00:00,Sachsen-Anhalt,259,286,2008,62486,91.0
2021-03-06 00:00:00+00:00,Sachsen-Anhalt,257,281,1972,62743,90.0
2021-03-07 00:00:00+00:00,Sachsen-Anhalt,187,283,1985,62930,90.0
2021-03-08 00:00:00+00:00,Sachsen-Anhalt,168,288,2022,63098,92.0
2021-03-09 00:00:00+00:00,Sachsen-Anhalt,348,284,1988,63446,91.0
2021-03-10 00:00:00+00:00,Sachsen-Anhalt,448,293,2053,63894,94.0
2021-03-11 00:00:00+00:00,Sachsen-Anhalt,509,310,2176,64403,99.0
2021-03-12 00:00:00+00:00,Sachsen-Anhalt,372,327,2289,64775,104.0
2021-03-13 00:00:00+00:00,Sachsen-Anhalt,419,350,2451,65194,112.0
2021-03-14 00:00:00+00:00,Sachsen-Anhalt,185,349,2449,65379,112.0
2021-03-15 00:00:00+00:00,Sachsen-Anhalt,150,347,2431,65529,111.0
2021-03-16 00:00:00+00:00,Sachsen-Anhalt,433,359,2516,65962,115.0
2021-03-17 00:00:00+00:00,Sachsen-Anhalt,490,365,2558,66452,117.0
2021-03-18 00:00:00+00:00,Sachsen-Anhalt,643,384,2692,67095,123.0
2021-03-19 00:00:00+00:00,Sachsen-Anhalt,487,401,2807,67582,128.0
2021-03-20 00:00:00+00:00,Sachsen-Anhalt,388,396,2776,67970,126.0
2021-03-21 00:00:00+00:00,Sachsen-Anhalt,231,403,2822,68201,129.0
2021-03-22 00:00:00+00:00,Sachsen-Anhalt,271,420,2943,68472,134.0
2021-03-23 00:00:00+00:00,Sachsen-Anhalt,619,447,3129,69091,143.0
2021-03-24 00:00:00+00:00,Sachsen-Anhalt,664,471,3303,69755,150.0
2021-03-25 00:00:00+00:00,Sachsen-Anhalt,692,478,3352,70447,153.0
2021-03-26 00:00:00+00:00,Sachsen-Anhalt,672,505,3537,71119,161.0
2021-03-27 00:00:00+00:00,Sachsen-Anhalt,636,540,3785,71755,172.0
2021-03-28 00:00:00+00:00,Sachsen-Anhalt,262,545,3816,72017,174.0
2021-03-29 00:00:00+00:00,Sachsen-Anhalt,277,546,3822,72294,174.0
2021-03-30 00:00:00+00:00,Sachsen-Anhalt,672,553,3875,72966,177.0
2021-03-31 00:00:00+00:00,Sachsen-Anhalt,667,554,3878,73633,177.0
2021-04-01 00:00:00+00:00,Sachsen-Anhalt,805,570,3991,74438,182.0
2021-04-02 00:00:00+00:00,Sachsen-Anhalt,568,555,3887,75006,177.0
2021-04-03 00:00:00+00:00,Sachsen-Anhalt,427,525,3678,75433,168.0
2021-04-04 00:00:00+00:00,Sachsen-Anhalt,226,520,3642,75659,166.0
2021-04-05 00:00:00+00:00,Sachsen-Anhalt,281,520,3646,75940,166.0
2021-04-06 00:00:00+00:00,Sachsen-Anhalt,351,475,3325,76291,151.0
2021-04-07 00:00:00+00:00,Sachsen-Anhalt,733,484,3391,77024,155.0
2021-04-08 00:00:00+00:00,Sachsen-Anhalt,826,487,3412,77850,155.0
2021-04-09 00:00:00+00:00,Sachsen-Anhalt,915,537,3759,78765,171.0
2021-04-10 00:00:00+00:00,Sachsen-Anhalt,677,572,4009,79442,183.0
2021-04-11 00:00:00+00:00,Sachsen-Anhalt,257,577,4040,79699,184.0
2021-04-12 00:00:00+00:00,Sachsen-Anhalt,365,589,4124,80064,188.0
2021-04-13 00:00:00+00:00,Sachsen-Anhalt,865,662,4638,80929,211.0
2021-04-14 00:00:00+00:00,Sachsen-Anhalt,913,688,4818,81842,220.0
2021-04-15 00:00:00+00:00,Sachsen-Anhalt,748,677,4740,82590,216.0
2021-04-16 00:00:00+00:00,Sachsen-Anhalt,809,662,4634,83399,211.0
2021-04-17 00:00:00+00:00,Sachsen-Anhalt,431,626,4388,83830,200.0
2021-04-18 00:00:00+00:00,Sachsen-Anhalt,223,622,4354,84053,198.0
2021-04-19 00:00:00+00:00,Sachsen-Anhalt,350,619,4339,84403,198.0
2021-04-20 00:00:00+00:00,Sachsen-Anhalt,703,596,4177,85106,190.0
2021-04-21 00:00:00+00:00,Sachsen-Anhalt,927,598,4191,86033,191.0
2021-04-22 00:00:00+00:00,Sachsen-Anhalt,749,598,4192,86782,191.0
2021-04-23 00:00:00+00:00,Sachsen-Anhalt,673,579,4056,87455,185.0
2021-04-24 00:00:00+00:00,Sachsen-Anhalt,523,592,4148,87978,189.0
2021-04-25 00:00:00+00:00,Sachsen-Anhalt,337,608,4262,88315,194.0
2021-04-26 00:00:00+00:00,Sachsen-Anhalt,354,609,4266,88669,194.0
2021-04-27 00:00:00+00:00,Sachsen-Anhalt,885,635,4448,89554,203.0
2021-04-28 00:00:00+00:00,Sachsen-Anhalt,691,601,4212,90245,192.0
2021-04-29 00:00:00+00:00,Sachsen-Anhalt,592,579,4055,90837,185.0
2021-04-30 00:00:00+00:00,Sachsen-Anhalt,575,565,3957,91412,180.0
2021-05-01 00:00:00+00:00,Sachsen-Anhalt,338,538,3772,91750,172.0
2021-05-02 00:00:00+00:00,Sachsen-Anhalt,178,516,3613,91928,165.0
2021-05-03 00:00:00+00:00,Sachsen-Anhalt,174,490,3433,92102,156.0
2021-05-04 00:00:00+00:00,Sachsen-Anhalt,626,453,3174,92728,145.0
2021-05-05 00:00:00+00:00,Sachsen-Anhalt,591,439,3074,93319,140.0
2021-05-06 00:00:00+00:00,Sachsen-Anhalt,493,425,2975,93812,136.0
2021-05-07 00:00:00+00:00,Sachsen-Anhalt,482,411,2882,94294,131.0
2021-05-08 00:00:00+00:00,Sachsen-Anhalt,353,413,2897,94647,132.0
2021-05-09 00:00:00+00:00,Sachsen-Anhalt,122,405,2841,94769,129.0
2021-05-10 00:00:00+00:00,Sachsen-Anhalt,147,402,2814,94916,128.0
2021-05-11 00:00:00+00:00,Sachsen-Anhalt,552,391,2740,95468,125.0
2021-05-12 00:00:00+00:00,Sachsen-Anhalt,426,367,2575,95894,117.0
2021-05-13 00:00:00+00:00,Sachsen-Anhalt,283,337,2365,96177,108.0
2021-05-14 00:00:00+00:00,Sachsen-Anhalt,224,301,2107,96401,96.0
2021-05-15 00:00:00+00:00,Sachsen-Anhalt,194,278,1948,96595,89.0
2021-05-16 00:00:00+00:00,Sachsen-Anhalt,106,276,1932,96701,88.0
2021-05-17 00:00:00+00:00,Sachsen-Anhalt,107,270,1892,96808,86.0
2021-05-18 00:00:00+00:00,Sachsen-Anhalt,286,232,1626,97094,74.0
2021-05-19 00:00:00+00:00,Sachsen-Anhalt,256,208,1456,97350,66.0
2021-05-20 00:00:00+00:00,Sachsen-Anhalt,207,197,1380,97557,63.0
2021-05-21 00:00:00+00:00,Sachsen-Anhalt,164,188,1320,97721,60.0
2021-05-22 00:00:00+00:00,Sachsen-Anhalt,128,179,1254,97849,57.0
2021-05-23 00:00:00+00:00,Sachsen-Anhalt,60,172,1208,97909,55.0
2021-05-24 00:00:00+00:00,Sachsen-Anhalt,30,161,1131,97939,52.0
2021-05-25 00:00:00+00:00,Sachsen-Anhalt,82,132,927,98021,42.0
2021-05-26 00:00:00+00:00,Sachsen-Anhalt,159,118,830,98180,38.0
2021-05-27 00:00:00+00:00,Sachsen-Anhalt,154,111,777,98334,35.0
2021-05-28 00:00:00+00:00,Sachsen-Anhalt,82,99,695,98416,32.0
2021-05-29 00:00:00+00:00,Sachsen-Anhalt,98,95,665,98514,30.0
2021-05-30 00:00:00+00:00,Sachsen-Anhalt,25,90,630,98539,29.0
2021-05-31 00:00:00+00:00,Sachsen-Anhalt,47,92,647,98586,29.0
2021-06-01 00:00:00+00:00,Sachsen-Anhalt,117,97,682,98703,31.0
2021-06-02 00:00:00+00:00,Sachsen-Anhalt,72,85,595,98775,27.0
2021-06-03 00:00:00+00:00,Sachsen-Anhalt,66,72,507,98841,23.0
2021-06-04 00:00:00+00:00,Sachsen-Anhalt,47,67,472,98888,22.0
2021-06-05 00:00:00+00:00,Sachsen-Anhalt,57,61,431,98945,20.0
2021-06-06 00:00:00+00:00,Sachsen-Anhalt,20,60,426,98965,19.0
2021-06-07 00:00:00+00:00,Sachsen-Anhalt,13,56,392,98978,18.0
2021-06-08 00:00:00+00:00,Sachsen-Anhalt,47,46,322,99025,15.0
2021-06-09 00:00:00+00:00,Sachsen-Anhalt,22,38,272,99047,12.0
2021-06-10 00:00:00+00:00,Sachsen-Anhalt,28,33,234,99075,11.0
2021-06-11 00:00:00+00:00,Sachsen-Anhalt,20,29,207,99095,9.0
2021-06-12 00:00:00+00:00,Sachsen-Anhalt,19,24,169,99114,8.0
2021-06-13 00:00:00+00:00,Sachsen-Anhalt,7,22,156,99121,7.0
2021-06-14 00:00:00+00:00,Sachsen-Anhalt,7,21,150,99128,7.0
2021-06-15 00:00:00+00:00,Sachsen-Anhalt,16,17,119,99144,5.0
2021-06-16 00:00:00+00:00,Sachsen-Anhalt,22,17,119,99166,5.0
2021-06-17 00:00:00+00:00,Sachsen-Anhalt,12,14,103,99178,5.0
2021-06-18 00:00:00+00:00,Sachsen-Anhalt,8,13,91,99186,4.0
2021-06-19 00:00:00+00:00,Sachsen-Anhalt,11,11,83,99197,4.0
2021-06-21 00:00:00+00:00,Sachsen-Anhalt,2,11,78,99199,4.0
2021-06-22 00:00:00+00:00,Sachsen-Anhalt,11,11,82,99210,4.0
2021-06-23 00:00:00+00:00,Sachsen-Anhalt,5,10,71,99215,3.0
2021-06-24 00:00:00+00:00,Sachsen-Anhalt,6,7,55,99221,3.0
2021-06-25 00:00:00+00:00,Sachsen-Anhalt,2,6,45,99223,2.0
2021-06-27 00:00:00+00:00,Sachsen-Anhalt,1,5,38,99224,2.0
2021-06-28 00:00:00+00:00,Sachsen-Anhalt,5,4,32,99229,1.0
2021-06-29 00:00:00+00:00,Sachsen-Anhalt,3,4,33,99232,2.0
2021-06-30 00:00:00+00:00,Sachsen-Anhalt,7,4,29,99239,1.0
2021-07-01 00:00:00+00:00,Sachsen-Anhalt,3,3,27,99242,1.0
2021-07-02 00:00:00+00:00,Sachsen-Anhalt,2,3,23,99244,1.0
2021-07-03 00:00:00+00:00,Sachsen-Anhalt,3,3,24,99247,1.0
2021-07-04 00:00:00+00:00,Sachsen-Anhalt,1,3,24,99248,1.0
2021-07-05 00:00:00+00:00,Sachsen-Anhalt,3,3,22,99251,1.0
2021-07-06 00:00:00+00:00,Sachsen-Anhalt,3,3,22,99254,1.0
